わんりょく	腕力
わんぱく	腕白
わんない	湾内
わんしょう	腕章
わんきょく	湾曲
わんがん	湾岸
わん	湾
わん	椀
われわれ	我々
われら	我ら
われめ	割れ目
われ	割れ
われ	我
わるもの	悪者
わるびれ	悪びれ
わるぢえ	悪知恵
わるだくみ	悪巧み
わるくち	悪口
わるぎ	悪気
わるあがき	悪あがき
わる	悪
わりやす	割安
わりもどし	割戻し
わりもど	割り戻
わりまし	割増し
わりふ	割り振
わりふ	割りふ
わりびきさい	割引債
わりびき	割引
わりび	割り引
わりばし	割箸
わりつけ	割り付け
わりだか	割高
わりざん	割算
わりこ	割り込
わりき	割り切
わりかん	割り勘
わりいん	割印
わりあて	割当
わりあて	割り当て
わりあい	割合
わり	割
わらべ	童
わらび	蕨
わら	藁
わら	笑
わら	稿
わよう	和洋
わやく	和訳
わめい	和名
わぼく	和睦
わほう	話法
わへい	和平
わぶん	和文
わふく	和服
わふう	和風
わびじょう	詫状
わび	詫び
わに	鰐
わな	罠
わとじ	和綴じ
わっか	輪っか
わたりどり	渡り鳥
わたり	渡り
わだち	轍
わたしぶね	渡し船
わたしども	私供
わたしども	私ども
わたしたち	私達
わたしたち	私たち
わたし	渡し
わたし	私
わたくしりつ	私立
わたくしたち	私達
わたくしごと	私事
わたくし	私
わだい	話題
わた	亙
わた	綿
わた	棉
わた	渡
わた	航
わせん	和戦
わせい	和声
わせ	早生
わせ	早稲
わすれさ	忘れ去
わすれ	忘れ
わずらわし	煩わし
わずらわ	煩わ
わずら	煩
わずら	患
わずか	僅か
わしょく	和食
わしゃ	話者
わしつ	和室
わしき	和式
わし	鷲
わし	和紙
わざわい	災い
わざわい	禍
わさび	山葵
わさい	和裁
わざ	業
わざ	技
わこんようさい	和魂洋才
わこうど	若人
わごう	和合
わご	和語
わけめ	分け目
わけまえ	分け前
わけい	分け入
わけあたえ	分け与え
わけ	訳
わけ	分け
わくらん	惑乱
わくない	枠内
わくせい	惑星
わくぐみ	枠組
わくがい	枠外
わく	枠
わぎり	輪切り
わぎゅう	和牛
わきみち	脇道
わきみず	湧き水
わきみ	わき見
わきまえ	弁え
わきばら	脇腹
わきた	沸き立
わきげ	脇毛
わきあいあい	和気靄々
わきあいあい	和気藹々
わぎ	和議
わき	脇
わかん	和姦
わかわかし	若々し
わかれ	別れ
わかれ	分かれ
わがや	我家
わがや	我が家
わかもの	若者
わかめ	若布
わがまま	我儘
わがまま	我侭
わがまま	我がまま
わかまつ	若松
わがはい	我輩
わかば	若葉
わかて	若手
わかちがき	わかち書き
わがし	和菓子
わがくに	我が国
わがくに	わが国
わかくさ	若草
わかがえ	若返
わかい	和解
わが	我が
わが	我
わか	和歌
わか	分か
わか	分
わか	沸か
わか	判
わか	若
わか	解
わえい	和英
わいろ	賄賂
わいだん	猥談
わいせつ	猥褻
わいせい	矮星
わいしょう	矮小
わいきょく	歪曲
わ	和
わ	輪
わ	涌
わ	湧
わ	沸
わ	環
わ	割
ろんり	論理
ろんぽう	論法
ろんぶんし	論文誌
ろんぶん	論文
ろんぴょう	論評
ろんばく	論駁
ろんなん	論難
ろんてん	論点
ろんてき	論敵
ろんちょう	論調
ろんだい	論題
ろんそう	論争
ろんせつ	論説
ろんじん	論陣
ろんしょう	論証
ろんじゅつ	論述
ろんじゃ	論者
ろんしゃ	論者
ろんし	論旨
ろんこく	論告
ろんこう	論攷
ろんこう	論考
ろんご	論語
ろんきょ	論拠
ろんきゅう	論究
ろんきゅう	論及
ろんぎ	論議
ろんがい	論外
ろん	論
ろめん	路面
ろばん	路盤
ろてん	露点
ろてん	露店
ろてん	露天
ろてい	露呈
ろっぽう	六法
ろっこつ	肋骨
ろちょう	顱頂
ろせん	路線
ろしん	炉心
ろじょう	路上
ろしゅつ	露出
ろじ	露地
ろじ	路地
ろこつ	露骨
ろこう	露光
ろけん	露見
ろくよう	六曜
ろくめんたい	六面体
ろくまく	肋膜
ろくぼく	肋木
ろくぶんぎ	六分儀
ろくしょう	緑青
ろくが	録画
ろくおん	録音
ろく	録
ろく	六
ろぎん	路銀
ろかた	路肩
ろーまじ	ローマ字
ろうれん	老練
ろうれつ	陋劣
ろうれい	老齢
ろうりょく	労力
ろうむ	労務
ろうぼく	老木
ろうほう	朗報
ろうぼ	老母
ろうふ	老父
ろうふ	老夫
ろうひ	浪費
ろうばしん	老婆心
ろうばい	狼狽
ろうはい	老廃
ろうば	老婆
ろうにん	浪人
ろうにゃく	老若
ろうどく	朗読
ろうどう	労働
ろうとう	郎等
ろうと	漏斗
ろうでん	漏電
ろうちん	労賃
ろうたい	老体
ろうそく	蝋燭
ろうそ	労組
ろうぜき	狼藉
ろうせき	蝋石
ろうすい	老衰
ろうすい	漏水
ろうじん	老人
ろうじょう	籠城
ろうじょう	老嬢
ろうしょう	労相
ろうしゅつ	漏出
ろうじゅく	老熟
ろうじゅう	老中
ろうじゃく	老弱
ろうし	浪士
ろうし	労使
ろうさく	労作
ろうさい	老妻
ろうさい	労災
ろうごく	牢獄
ろうご	老後
ろうけつ	蝋纈
ろうく	労苦
ろうきょく	浪曲
ろうきょう	老境
ろうきゅう	老朽
ろうがん	老眼
ろうかい	老獪
ろうか	老化
ろうか	廊下
ろうえい	漏洩
ろうあ	聾唖
ろう	聾
ろう	老
ろう	朗
ろう	弄
ろう	労
ろ	炉
ろ	櫓
れんりつ	連立
れんらく	連絡
れんようけい	連用形
れんよう	連用
れんや	連夜
れんめん	連綿
れんめい	連盟
れんめい	連名
れんま	錬磨
れんぽう	連邦
れんぽう	連峰
れんぶんせつ	連文節
れんびん	憐憫
れんぱつ	連発
れんぱい	連敗
れんぱ	連破
れんぱ	連覇
れんねん	連年
れんどう	連動
れんとう	連騰
れんちゅう	連中
れんだん	連弾
れんたつ	練達
れんだく	連濁
れんたいし	連体詞
れんたい	連隊
れんたい	連帯
れんたい	連体
れんだ	連打
れんぞくたい	連続体
れんぞく	連続
れんそう	連想
れんせん	連戦
れんせつ	連接
れんせい	錬成
れんせい	連成
れんしょう	連勝
れんしょ	連署
れんしゅう	練習
れんじゅ	連珠
れんしゃ	連射
れんじつ	連日
れんざん	連山
れんさく	連作
れんさい	連載
れんざ	連座
れんさ	連鎖
れんこん	蓮根
れんごう	連合
れんこう	連行
れんご	連語
れんこ	連呼
れんげんし	連言肢
れんげん	連言
れんけつ	連結
れんけい	連携
れんけい	連係
れんきんじゅつ	錬金術
れんきゅう	連休
れんき	連記
れんかん	連関
れんが	煉瓦
れんか	廉価
れんあい	恋愛
れん	連
れっぱく	烈帛
れっとう	劣等
れっとう	列島
れつでん	列伝
れっせき	列席
れっせい	劣性
れっせい	劣勢
れっしん	烈震
れっしょう	裂傷
れっしゃ	列車
れっこく	列国
れっきょう	列強
れっきょ	列挙
れっきと	歴と
れっき	列記
れっか	烈火
れっか	劣化
れつあく	劣悪
れつ	列
れきれき	歴々
れきほう	歴訪
れきだい	歴代
れきぜん	歴然
れきし	轢死
れきし	歴史
れき	歴
れき	暦
れいれいし	麗々し
れいめい	黎明
れいぼう	冷房
れいほう	礼砲
れいほう	礼法
れいぶん	例文
れいふく	礼服
れいふう	冷風
れいばい	霊媒
れいばい	冷媒
れいねん	例年
れいねつ	冷熱
れいにゅう	戻入
れいとう	冷凍
れいど	零度
れいちょう	霊長
れいたん	冷淡
れいだい	例題
れいそく	令息
れいぞうこ	冷蔵庫
れいぞう	冷蔵
れいぜん	霊前
れいせん	零戦
れいせん	冷戦
れいせい	冷静
れいすい	冷水
れいじょう	霊場
れいじょう	礼状
れいじょう	令状
れいじょう	令嬢
れいしょう	冷笑
れいしょう	例証
れいしょ	隷書
れいじ	零時
れいじ	例示
れいさい	零細
れいこん	霊魂
れいこく	冷酷
れいこう	励行
れいげん	霊験
れいけん	霊験
れいけつかん	冷血漢
れいげつ	例月
れいけつ	冷血
れいぐう	冷遇
れいきん	礼金
れいきゅうしゃ	霊柩車
れいきゃく	冷却
れいぎ	礼儀
れいき	冷気
れいかん	霊感
れいがい	冷害
れいがい	例外
れいかい	例解
れいかい	例会
れいか	零下
れいか	冷夏
れいえん	霊園
れいあんしょ	冷暗所
れいあんしつ	霊安室
れい	霊
れい	零
れい	礼
れい	例
るろう	流浪
るり	瑠璃
るふ	流布
るてん	流転
るすばん	留守番
るす	留守
るいるい	累々
るいべつ	類別
るいどう	類同
るいせん	涙腺
るいせき	累積
るいすい	類推
るいしん	累進
るいしん	塁審
るいじょう	累乗
るいしょう	類焼
るいしょ	類書
るいじ	類字
るいじ	類似
るいご	類語
るいけい	累計
るいえん	類縁
るい	類
るい	累
るい	塁
りんりつ	林立
りんり	倫理
りんや	林野
りんね	輪廻
りんどう	林道
りんどう	竜胆
りんと	凛と
りんてん	輪転
りんせんたいせい	臨戦体制
りんせつ	隣接
りんせき	臨席
りんず	綸子
りんじん	隣人
りんしょく	吝嗇
りんじょう	臨場
りんしょう	輪唱
りんしょう	臨床
りんじゅう	臨終
りんじ	臨時
りんさん	林産
りんごく	隣国
りんこう	輪講
りんげん	綸言
りんけん	臨検
りんげつ	臨月
りんくう	臨空
りんぎょう	林業
りんきおうへん	臨機応変
りんぎ	稟議
りんかん	林間
りんかく	輪郭
りんかい	臨界
りんかい	臨海
りんか	隣家
りん	鈴
りん	燐
りん	厘
りろん	理論
りろせいぜん	理路整然
りれきしょ	履歴書
りれき	履歴
りりつ	利率
りりし	凛々し
りりく	離陸
りょひ	旅費
りょてい	旅程
りょっか	緑化
りょだん	旅団
りょじょう	旅情
りょこう	旅行
りょけん	旅券
りょくちゃ	緑茶
りょくち	緑地
りょくしょく	緑色
りょかん	旅館
りょかく	旅客
りょがい	慮外
りょうろん	両論
りょうりつ	両立
りょうり	料理
りょうよく	両翼
りょうよう	療養
りょうよう	両用
りょうよう	両様
りょうゆう	領有
りょうめん	両面
りょうめ	両目
りょうみ	涼味
りょうほう	療法
りょうほう	両方
りょうぼ	陵墓
りょうぼ	寮母
りょうぶん	領分
りょうぶん	両分
りょうひ	良否
りょうはし	両端
りょうは	両派
りょうねん	両年
りょうにん	両人
りょうない	領内
りょうとく	両得
りょうとうづかい	両刀使い
りょうどう	糧道
りょうどう	両道
りょうど	領土
りょうてき	量的
りょうてい	料亭
りょうて	両手
りょうち	領地
りょうだん	両断
りょうたん	両端
りょうぞく	良俗
りょうぜん	霊山
りょうせん	稜線
りょうせい	良性
りょうせい	両性
りょうじん	良人
りょうしん	良心
りょうしん	両親
りょうじょく	凌辱
りょうしょく	糧食
りょうしょう	諒承
りょうしょう	了承
りょうじゅう	猟銃
りょうしゅう	領袖
りょうしゅう	領収
りょうしゅ	領主
りようしゃ	利用者
りょうしゃ	両者
りょうしゃ	両社
りょうじつ	両日
りょうしつ	良質
りょうしき	良識
りょうじ	領事
りょうじ	療治
りょうし	量子
りょうし	猟師
りょうし	両氏
りょうし	両市
りょうし	漁師
りょうさん	量産
りょうさく	良策
りょうさいけんぼ	良妻賢母
りょうこく	両国
りょうこう	良好
りようけん	利用券
りょうけん	猟犬
りょうけん	料簡
りょうけん	両県
りょうけん	了見
りょうけ	両家
りょうくう	領空
りょうきん	料金
りょうきょく	両極
りょうき	猟奇
りょうかん	量感
りょうがわ	両側
りょうがえ	両替
りょうかい	領海
りょうかい	諒解
りょうかい	了解
りょうが	凌駕
りょうえん	良縁
りょういん	両院
りょういき	領域
りょうあし	両足
りよう	理容
りよう	利用
りょう	領
りょう	量
りょう	諒
りょう	良
りょう	猟
りょう	料
りょう	寮
りょう	両
りょう	了
りょう	漁
りゅうりょう	流量
りゅうよう	流用
りゅうほ	留保
りゅうひょう	流氷
りゅうは	流派
りゅうねん	留年
りゅうにん	留任
りゅうにゅう	流入
りゅうとうだび	龍頭蛇尾
りゅうとうだび	竜頭蛇尾
りゅうどう	流動
りゅうど	粒度
りゅうつう	流通
りゅうちょう	流暢
りゅうち	留置
りゅうだん	榴弾
りゅうたい	流体
りゅうそく	流速
りゅうせい	隆盛
りゅうすい	流水
りゅうず	竜頭
りゅうしゅつ	流出
りゅうしつ	流失
りゅうし	粒子
りゅうざん	流産
りゅうさん	硫酸
りゅうこう	流行
りゅうげんひご	流言蜚語
りゅうげんひご	流言飛語
りゅうげん	流言
りゅうけつ	流血
りゅうぎ	流儀
りゅうき	隆起
りゅうがん	竜顔
りゅうかん	流感
りゅうがくせい	留学生
りゅうがく	留学
りゅうかい	流会
りゅうか	硫化
りゅういん	溜飲
りゅういき	流域
りゅうい	留意
りゆう	理由
りゅう	龍
りゅう	竜
りゅう	流
りゃっき	略記
りゃっかい	略解
りゃくれき	略歴
りゃくひつ	略筆
りゃくだつ	略奪
りゃくそう	略装
りゃくず	略図
りゃくしょう	略称
りゃくしき	略式
りゃくじ	略字
りゃくご	略語
りゃくぎ	略儀
りゃくかい	略解
りゃく	略
りめん	裏面
りまわり	利回り
りべん	利便
りべつ	離別
りふじん	理不尽
りばらい	利払い
りはっちゃく	離発着
りはつ	理髪
りはつ	利発
りのう	離農
りねん	理念
りにゅう	離乳
りとく	利得
りとう	離島
りてん	利点
りつろん	立論
りづめ	理詰め
りっぽうたい	立方体
りっぽう	立法
りっぷく	立腹
りっぱ	立派
りつどう	律動
りっとう	立冬
りったい	立体
りっそく	律速
りつぞう	立像
りつぜん	慄然
りっしん	立身
りっしょく	立食
りっしょう	立証
りっしゅん	立春
りっしゅう	立秋
りっし	立志
りっこうほ	立候補
りっけん	立憲
りっきょう	陸橋
りっきゃく	立脚
りっか	立夏
りつあん	立案
りつ	葎
りつ	率
りつ	律
りっ	律
りちゃっかん	離着艦
りちゃくりく	離着陸
りちぎ	律義
りちぎ	律儀
りち	理知
りだつ	離脱
りた	利他
りそん	離村
りそく	利息
りそう	理想
りせい	理性
りすうけい	理数系
りしんろん	理神論
りしょく	離職
りじゅん	利潤
りしゅう	履修
りじ	理事
りし	利子
りさん	離散
りざや	利鞘
りこん	離婚
りごう	離合
りこう	理工
りこう	履行
りこ	利己
りけん	利権
りけい	理系
りくろ	陸路
りくとう	陸稲
りくつ	理屈
りくち	陸地
りくじょう	陸上
りくぐん	陸軍
りくかいぐん	陸海軍
りくうん	陸運
りくあげ	陸揚げ
りく	陸
りきりょう	力量
りきゅう	離宮
りきとう	力闘
りきせん	力戦
りきせつ	力説
りきし	力士
りきさく	力作
りきがく	力学
りきえん	力演
りき	力
りき	利器
りがくぶ	理学部
りがく	理学
りがい	利害
りかい	理解
りか	理科
りえき	利益
りいん	吏員
り	里
り	裏
り	理
り	利
らんりつ	乱立
らんらん	爛々
らんよう	濫用
らんよう	乱用
らんみゃく	乱脈
らんまん	爛漫
らんま	欄間
らんぼう	乱暴
らんぶ	乱舞
らんぴ	乱費
らんぱつ	乱発
らんばつ	乱伐
らんぱく	卵白
らんにゅう	乱入
らんどく	乱読
らんとう	乱闘
らんちょう	乱調
らんちょう	乱丁
らんそう	卵巣
らんせん	乱戦
らんすう	乱数
らんじゅく	爛熟
らんしゃ	乱射
らんし	卵子
らんし	乱視
らんざつ	乱雑
らんこん	乱婚
らんこうげ	乱高下
らんこう	乱交
らんきりゅう	乱気流
らんぎょう	乱行
らんかん	欄干
らんかく	乱獲
らんがい	欄外
らんおう	卵黄
らん	覧
らん	蘭
らん	欄
らん	卵
らん	乱
られつ	羅列
らでん	螺鈿
らつわん	辣腕
らっかん	楽観
らっか	落下
らち	拉致
らち	埓
らせん	螺旋
らしんばん	羅針盤
らしゅつ	裸出
らくるい	落涙
らくらく	楽々
らくらい	落雷
らくよう	落葉
らくばん	落磐
らくはく	落魄
らくば	落馬
らくのう	酪農
らくてん	楽天
らくちょう	落丁
らくちゃく	落着
らくたん	落胆
らくだい	落第
らくだ	駱駝
らくせん	落選
らくせき	落石
らくせい	落成
らくしょう	楽勝
らくしゅ	落手
らくじつ	落日
らくさつ	落札
らくさ	落差
らくご	落語
らくご	落後
らくがん	落雁
らくがき	落書き
らくがき	落書
らくえん	楽園
らく	楽
らがん	裸眼
らいれき	来歴
らいらく	磊落
らいめい	雷鳴
らいほう	来訪
らいひん	来賓
らいはい	礼拝
らいねんど	来年度
らいねん	来年
らいにち	来日
らいてん	来店
らいちょう	雷鳥
らいちょう	来聴
らいたく	来宅
らいせ	来世
らいしん	来診
らいしん	来信
らいじょう	来場
らいしょ	来所
らいしゅん	来春
らいしゅう	来週
らいしゅう	来襲
らいしゅう	来秋
らいしゃ	来社
らいさん	礼賛
らいさん	礼讃
らいごう	来降
らいこう	来航
らいこう	来校
らいこう	来光
らいげつ	来月
らいく	ライク
らいきゃく	来客
らいき	来季
らいき	来期
らいかん	来館
らいかい	来会
らいか	来夏
らいえん	来演
らいう	雷雨
らい	雷
らーゆ	辣油
よんどころな	拠ん所な
よん	四
よわよわし	弱々し
よわめ	弱め
よわみ	弱味
よわま	弱ま
よわね	弱音
よわごし	弱腰
よわき	弱気
よわい	齢
よわ	弱
よろん	世論
よろず	万
よろしく	宜しく
よろし	宜し
よろこばし	喜ばし
よろこ	慶
よろこ	喜
よろこ	歓
よろこ	悦
よろく	余録
よろい	鎧
よる	夜
よりょく	余力
よりみち	寄り道
よりどころ	拠り所
よりそ	寄り添
よりき	与力
よりかか	寄り掛か
よりかか	寄りかか
よりあ	寄り合
よゆう	余裕
よやく	予約
よもぎ	蓬
よめさん	嫁さん
よめ	嫁
よみふけ	読み耽
よみち	夜道
よみこ	読み込
よみがな	読みがな
よみかた	読み方
よみかき	読み書き
よみがえ	甦
よみがえ	蘇
よみあげ	読み上げ
よまいごと	世迷い言
よぼう	予防
よほう	予報
よぶん	余分
よふけ	夜更け
よふかし	夜更し
よびよせ	呼び寄せ
よびもど	呼び戻
よびだし	呼出し
よびだし	呼出
よびだ	呼び出
よびごえ	呼び声
よびこう	予備校
よびこ	呼び込
よびぐん	予備軍
よびかけ	呼掛け
よびかけ	呼びかけ
よび	予備
よはく	余白
よばい	夜這い
よは	余波
よのなか	世の中
よねん	余念
よねつ	余熱
よなか	夜中
よとう	与党
よど	淀
よてい	予定
よっぱら	酔っ払
よっつ	四つ
よっきゅう	欲求
よつぎ	世継
よつかど	四つ角
よっか	四日
よっか	4日
よっか	４日
よちょきん	預貯金
よちょう	予兆
よち	余地
よち	予知
よだん	余談
よだん	予断
よたく	預託
よぞら	夜空
よそじ	四十路
よそく	予測
よそお	装
よそうがい	予想外
よそう	予想
よせん	予餞
よせん	予選
よせがき	寄書き
よせい	余生
よせ	寄席
よせ	寄せ
よじん	余人
よしん	余震
よじょう	余情
よじょう	余剰
よしゅう	予習
よしあし	善し悪し
よし	由
よし	好
よし	葦
よさん	予算
よさそう	良さそう
よこれんぼ	横恋慕
よごれ	汚れ
よこめ	横目
よこみち	横道
よこばい	横ばい
よこなが	横長
よこどり	横取り
よこて	横手
よこづな	横綱
よこたわ	横たわ
よこじま	横縞
よこしま	邪
よこざま	横様
よこく	予告
よこぎ	横切
よこがお	横顔
よこう	予行
よこう	予稿
よご	予後
よご	汚
よこ	横
よげん	預言
よげん	余弦
よげん	予言
よけい	余計
よけ	避け
よくりゅう	抑留
よくよくじつ	翌々日
よくよう	浴用
よくよう	抑揚
よくめんかじゅう	翼面荷重
よくぼう	欲望
よくば	欲張
よくねん	翌年
よくとし	翌年
よくとく	欲得
よくど	沃土
よくちょう	翌朝
よくたん	翼端
よくそう	浴槽
よくせい	抑制
よくじょう	浴場
よくしゅう	翌週
よくじつ	翌日
よくしつ	浴室
よくし	抑止
よくげつ	翌月
よくあつ	抑圧
よく	良く
よく	浴
よく	欲
よく	慾
よきん	預金
よきょう	余興
よぎな	余儀な
よき	予期
よかん	予感
よかく	与格
よか	余暇
よか	予価
ようろく	要録
ようろう	養老
ようれき	陽暦
ようれい	用例
ようりょくたい	葉緑体
ようりょくそ	葉緑素
ようりょく	揚力
ようりょう	要領
ようりょう	容量
ようりく	揚陸
ようらんき	揺籃期
ようらん	要覧
ようよう	洋々
ようゆう	熔融
ようやく	要約
ようもの	洋物
ようもう	羊毛
ようめい	用命
ようむ	用務
ようま	洋間
ようぼう	要望
ようぼう	容貌
ようほう	用法
ようへい	用兵
ようぶん	養分
ようふぼ	養父母
ようふく	洋服
ようふう	洋風
ようふ	養父
ようひん	洋品
ようひし	羊皮紙
ようび	曜日
ようねん	幼年
ようにん	容認
ようとん	養豚
ようど	用度
ようと	杳と
ようと	用途
ようでんし	陽電子
ようてん	要点
ようてい	要諦
ようちょう	羊腸
ようちゅう	幼虫
ようちえん	幼稚園
ようちあさがけ	夜討ち朝駆け
ようち	用地
ようち	幼稚
ようだい	容体
ようそう	様相
ようそ	要素
ようせん	用箋
ようせつ	夭折
ようせつ	熔接
ようせつ	溶接
ようせき	容積
ようせい	夭逝
ようせい	養成
ようせい	陽性
ようせい	要請
ようせい	妖精
ようすい	用水
ようす	様子
ようじん	要人
ようじん	用心
ようしょく	養殖
ようしょく	要職
ようしょく	洋食
ようしょく	容色
ようじょう	養生
ようじょう	洋上
ようしょう	要衝
ようしょう	幼少
ようじょ	養女
ようじょ	幼女
ようしょ	要所
ようしょ	洋書
ようしゅん	陽春
ようじゅつ	妖術
ようしゅ	洋酒
ようしゃな	容赦な
ようしゃ	容赦
ようしつ	洋室
ようしき	洋式
ようしき	様式
ようじ	用事
ようじ	幼児
ようし	養子
ようし	陽子
ようし	要旨
ようし	用紙
ようし	容姿
ようさん	養蚕
ようさい	要塞
ようさい	洋裁
ようこうろ	溶鉱炉
ようこう	陽光
ようこう	要項
ようこう	洋行
ようご	養護
ようご	用語
ようご	擁護
ようげん	用言
ようけん	要件
ようけん	用件
ようげき	邀撃
ようけい	養鶏
ようぐ	用具
ようぎん	洋銀
ようきょく	陽極
ようきょく	謡曲
ようぎょう	窯業
ようきゅう	要求
ようぎ	容疑
ようき	陽気
ようき	容器
ようかん	羊羹
ようかん	洋館
ようがし	洋菓子
ようがく	洋楽
ようかい	熔解
ようかい	溶解
ようかい	容喙
ようかい	妖怪
ようが	陽画
ようが	洋画
ようか	八日
ようか	8日
ようか	８日
ようおん	拗音
ようえき	溶液
よういん	要因
よういん	要員
よういく	養育
よういおん	陽イオン
ようい	用意
ようい	容易
よう	陽
よう	要
よう	用
よう	洋
よう	様
よう	楊
よう	擁
よいん	余韻
よいっぱり	宵っ張り
よい	宵
よあけ	夜明け
よ	縒
よ	良
よ	余
よ	夜
よ	撚
よ	読
よ	代
よ	善
よ	選
よ	世
よ	酔
よ	止
よ	好
よ	呼
よ	寄
よ	佳
よ	詠
よ	因
よ	依
ゆわかし	湯沸し
ゆわえ	結わえ
ゆれ	揺れ
ゆるやか	緩やか
ゆるめ	緩め
ゆる	揺る
ゆる	許
ゆる	緩
ゆり	百合
ゆらい	由来
ゆら	揺ら
ゆよく	湯浴
ゆめみ	夢見
ゆめ	夢
ゆみ	弓
ゆまく	油膜
ゆぶね	湯舟
ゆびわ	指輪
ゆびさき	指先
ゆびさ	指さ
ゆび	指
ゆのみ	湯飲み
ゆにゅう	輸入
ゆどうふ	湯豆腐
ゆでん	油田
ゆで	茹で
ゆちゃく	癒着
ゆたんぽ	湯たんぽ
ゆだん	油断
ゆだね	委ね
ゆたか	豊か
ゆたか	豊
ゆそう	輸送
ゆせい	油性
ゆせい	油井
ゆずりあ	譲り合
ゆず	柚
ゆず	譲
ゆす	濯
ゆしゅつにゅう	輸出入
ゆしゅつ	輸出
ゆし	油脂
ゆざまし	湯冷まし
ゆさぶ	揺さぶ
ゆけつ	輸血
ゆげ	湯気
ゆくえ	行方
ゆきみ	雪見
ゆきとど	行き届
ゆきどけ	雪解け
ゆきげしょう	雪化粧
ゆきぐに	雪国
ゆきき	行き来
ゆきか	行き交
ゆき	雪
ゆき	幸
ゆかん	湯潅
ゆかた	浴衣
ゆかした	床下
ゆかうえ	床上
ゆかい	愉快
ゆが	歪
ゆが	湯が
ゆか	由佳
ゆか	床
ゆえ	故
ゆえ	結え
ゆうわく	誘惑
ゆうわ	融和
ゆうわ	宥和
ゆうれつ	優劣
ゆうれい	幽霊
ゆうりょく	有力
ゆうりょう	有料
ゆうりょう	優良
ゆうりょ	憂慮
ゆうりすう	有理数
ゆうり	遊離
ゆうり	有理
ゆうり	有利
ゆうらん	遊覧
ゆうよく	游弋
ゆうよう	有用
ゆうよう	悠揚
ゆうよ	猶予
ゆうよ	有余
ゆうゆうじてき	悠々自適
ゆうゆう	悠々
ゆうやみ	夕闇
ゆうやけ	夕焼け
ゆうやく	釉薬
ゆうやく	勇躍
ゆうめし	夕飯
ゆうめい	有名
ゆうみん	遊民
ゆうほどう	遊歩道
ゆうぼく	遊牧
ゆうぼう	有望
ゆうほう	友朋
ゆうべん	雄弁
ゆうべ	夕べ
ゆうべ	昨夜
ゆうふく	裕福
ゆうびんぶつ	郵便物
ゆうびんきょく	郵便局
ゆうびん	郵便
ゆうび	優美
ゆうひ	夕陽
ゆうひ	夕日
ゆうはん	夕飯
ゆうはつ	誘発
ゆうのう	有能
ゆうどく	有毒
ゆうどう	誘導
ゆうとう	優等
ゆうづう	融通
ゆうちょう	悠長
ゆうちょ	郵貯
ゆうち	誘致
ゆうだん	勇断
ゆうだち	夕立ち
ゆうだい	雄大
ゆうたい	優待
ゆうそくこじつ	有職故実
ゆうそう	雄壮
ゆうそう	郵送
ゆうぜん	悠然
ゆうぜん	友禅
ゆうせん	郵船
ゆうせん	有線
ゆうせん	優先
ゆうせつ	融雪
ゆうぜい	遊説
ゆうぜい	有税
ゆうせい	遊星
ゆうせい	有性
ゆうせい	優生
ゆうせい	優性
ゆうせい	優勢
ゆうすずみ	夕涼み
ゆうずうむげ	融通無碍
ゆうずう	融通
ゆうすう	有数
ゆうすいち	遊水池
ゆうすい	湧水
ゆうしんろん	有神論
ゆうじん	有人
ゆうじん	友人
ゆうしょく	夕食
ゆうじょう	友情
ゆうしょう	有償
ゆうしょう	優勝
ゆうじょ	遊女
ゆうじょ	宥恕
ゆうしゅん	優駿
ゆうしゅつ	湧出
ゆうじゅうふだん	優柔不断
ゆうしゅう	憂愁
ゆうしゅう	優秀
ゆうしてっせん	有刺鉄線
ゆうしきしゃ	有識者
ゆうしかい	有視界
ゆうし	融資
ゆうし	有志
ゆうざい	有罪
ゆうこん	雄渾
ゆうこく	夕刻
ゆうごう	融合
ゆうこう	有効
ゆうこう	友好
ゆうげんようそほう	有限要素法
ゆうけんしゃ	有権者
ゆうげんがいしゃ	有限会社
ゆうげん	有限
ゆうけい	有形
ゆうげ	夕餉
ゆうぐれ	夕暮れ
ゆうぐう	優遇
ゆうきゅう	遊休
ゆうきゅう	有給
ゆうきゅう	有休
ゆうきゅう	悠久
ゆうき	有機
ゆうき	勇気
ゆうかん	夕刊
ゆうかん	勇敢
ゆうがとう	誘蛾灯
ゆうがた	夕方
ゆうがく	遊学
ゆうがい	有害
ゆうかい	融解
ゆうかい	誘拐
ゆうが	優雅
ゆうか	有価
ゆうえんち	遊園地
ゆうえつ	優越
ゆうえき	有益
ゆうえい	游泳
ゆうえい	遊泳
ゆううつ	憂鬱
ゆういん	誘引
ゆういぎ	有意義
ゆうい	有意
ゆうい	優位
ゆう	夕
ゆう	有
ゆう	優
ゆいぶつ	唯物
ゆいのう	結納
ゆいしょ	由緒
ゆいごん	遺言
ゆいがどくそん	唯我独尊
ゆいいつ	唯一
ゆあつ	油圧
ゆ	揺
ゆ	湯
ゆ	逝
ゆ	行
ゆ	結
ゆ	往
やんぐりつ	ヤング率
やわらか	軟らか
やわらか	柔らか
やわら	和ら
やわはだ	柔肌
やろうじだい	夜郎自大
やろう	野郎
やりなお	やり直
やりとり	やり取り
やりて	やり手
やりだま	やり玉
やりすご	やり過ご
やり	鑓
やり	槍
やらい	夜来
やよい	弥生
やゆ	椰揄
やゆ	揶揄
やめ	辞め
やめ	止め
やむをえな	やむを得な
やむをえず	やむを得ず
やむをえ	やむを得
やむちゃ	飲茶
やみつき	病み付き
やみうち	闇討ち
やみ	闇
やまわけ	山分け
やまやま	山々
やまもり	山盛り
やまはだ	山肌
やまば	山場
やまのぼり	山登り
やまのて	山の手
やまと	大和
やまて	山手
やまづみ	山積み
やますそ	山裾
やまし	疚し
やまし	山師
やまざと	山里
やまざくら	山桜
やまごや	山小屋
やまぐに	山国
やまくずれ	山崩れ
やまがわ	山側
やまかわ	山川
やまがら	山雀
やまおく	山奥
やまい	病
やまあい	山間
やま	山
やぼう	野望
やぼ	野暮
やぶん	夜分
やぶれめ	破れ目
やぶれさ	敗れ去
やぶれかぶれ	破れかぶれ
やぶれ	敗れ
やぶへび	薮蛇
やぶからぼう	薮から棒
やぶ	薮
やぶ	破
やひ	野卑
やばん	野蛮
やはん	夜半
やね	屋根
やぬし	家主
やにさが	やに下が
やに	脂
やなぎば	柳刃
やなぎ	柳
やな	梁
やどや	宿屋
やとう	野盗
やとう	野党
やといぬし	雇主
やとい	雇
やど	宿
やつら	奴ら
やつめうなぎ	鱧
やっつ	八つ
やっこ	奴
やっきょく	薬局
やっきょう	薬莢
やっき	躍起
やっかん	約款
やっかい	厄介
やっか	薬価
やつ	八
やつ	奴
やちん	家賃
やちょう	野鳥
やちよ	八千代
やたい	屋台
やそじ	八十路
やそうきょく	夜想曲
やそう	野草
やせん	夜戦
やせほそ	やせ細
やせおとろえ	やせ衰え
やせい	野生
やせい	野性
やせ	痩せ
やすん	安ん
やすらか	安らか
やすら	安ら
やすもの	安物
やすみ	休み
やすま	休ま
やすぶしん	安普請
やすね	安値
やすっぽ	安っぽ
やすうり	安売り
やすあがり	安上がり
やす	休
やす	易
やす	安
やじん	野人
やしん	野心
やしろ	社
やじるし	矢印
やしょく	夜食
やじゅう	野獣
やしゅ	野手
やしな	養
やしき	屋敷
やじうま	野次馬
やじ	野次
やし	椰子
やし	香具師
やさし	優し
やさし	易し
やさき	矢先
やさい	野菜
やごう	屋号
やこう	夜行
やこう	夜光
やけぼっくい	焼け棒杭
やけぼっくい	焼けぼっくい
やけど	火傷
やけつ	焼け付
やけい	夜警
やけい	夜景
やけ	焼け
やけ	灼け
やくわり	役割
やぐら	櫓
やくよう	薬用
やくめ	役目
やくまん	役満
やくほうし	薬包紙
やくぶん	訳文
やくぶん	約分
やくぶつ	薬物
やくひん	薬品
やくば	役場
やくにん	役人
やくどし	厄年
やくどく	訳読
やくどく	役得
やくとく	役得
やくどう	躍動
やくだ	役立
やくそく	約束
やくそう	薬草
やくすう	約数
やくしん	躍進
やくしょく	役職
やくじょう	約定
やくじょ	躍如
やくしょ	役所
やくしゅつ	訳出
やくしゃ	訳者
やくしゃ	役者
やくざい	薬剤
やくご	訳語
やくがら	役柄
やくがくぶ	薬学部
やくがく	薬学
やくがい	薬害
やくいん	役員
やく	訳
やく	薬
やく	約
やく	役
やく	厄
やきん	夜勤
やきん	冶金
やきゅう	野球
やきもの	焼物
やきにく	焼肉
やきつけ	焼付け
やきつ	焼き付
やきいも	焼き芋
やぎ	夜着
やぎ	山羊
やかん	夜間
やから	輩
やかまし	喧し
やかた	舘
やかた	館
やかた	屋形
やがく	夜学
やがい	野外
やおや	八百屋
やおもて	矢面
やおちょう	八百長
やえば	八重歯
やえい	野営
やえ	八重
やいば	刃
や	矢
や	野
や	病
や	妬
や	焼
や	殺
や	遣
や	屋
もんよう	文様
もんめ	匁
もんぶ	文部
もんぴょう	門標
もんぴ	門扉
もんばん	門番
もんばつ	門閥
もんどりう	もんどり打
もんどころ	紋所
もんどう	問答
もんとう	門灯
もんてい	門弟
もんつき	紋付
もんちゃく	悶着
もんだいてん	問題点
もんだい	問題
もんぜんばらい	門前払い
もんぜん	門前
もんしん	問診
もんしょう	紋章
もんし	門歯
もんし	悶死
もんこ	門戸
もんげん	門限
もんく	文句
もんきりがた	紋切り型
もんがいかん	門外漢
もんがい	門外
もんか	門下
もん	門
もん	紋
もろもろ	諸々
もろ	脆
もろ	諸
もれ	洩れ
もりたて	盛り立て
もりたて	守り立て
もりこ	盛り込
もりかえ	盛りかえ
もりあげ	盛り上げ
もりあが	盛り上が
もり	杜
もり	森
もり	守
もら	漏ら
もら	貰
もより	最寄り
もよお	催
もよう	模様
もやし	萌やし
もや	靄
もや	母屋
もや	燃や
もも	桃
もも	腿
もも	股
もめん	木綿
もめごと	揉め事
もめ	揉め
もみじ	紅葉
もみじ	椛
もみけ	揉み消
もみけ	もみ消
もほう	模倣
もふく	喪服
もはん	模範
もはや	最早
ものめずらし	物珍し
ものほし	物干し
ものたりな	物足りな
ものすご	物凄
ものずき	物好き
ものしり	物知り
ものしずか	物静か
ものさし	物差し
ものごと	物事
ものごい	物乞い
ものがなし	物悲し
ものがなし	もの悲し
ものがたり	物語
ものかき	物書き
ものおもい	物思い
ものおと	物音
ものおき	物置
もの	物
もの	者
もともと	元々
もとめ	求め
もとむ	求む
もとま	求ま
もとね	元値
もとどおり	元通り
もとで	元手
もとづ	基づ
もとちょう	元帳
もとせん	元栓
もとじめ	元締め
もとき	本木
もとうけ	元請け
もとい	基
もど	戻
もと	素
もと	元
もと	求
もと	基
もと	下
もでるか	モデル化
もてあま	持て余
もてあそ	弄
もつやく	没薬
もっぱら	専ら
もっとも	尤も
もっとも	最も
もって	以て
もって	以って
もったい	勿体
もっこう	木工
もっこう	木瓜
もちろんの	勿論の
もちろん	勿論
もちよ	持ち寄
もちゅう	喪中
もちまわ	持ち回
もちはだ	餅肌
もちはこ	持ち運
もちなお	持ち直
もちづき	望月
もちだ	持ち出
もちさ	持ち去
もちごめ	餅米
もちこ	持ち込
もちこ	持ち越
もちかけ	持ち掛け
もちい	用い
もちあわ	持ち合わ
もちある	持ち歩
もちあげ	持ち上げ
もちあが	持ち上が
もち	餅
もち	持ち
もだえ	悶え
もぞう	模造
もず	鵙
もず	百舌
もしょう	喪章
もしゅ	喪主
もしゃ	模写
もじばけ	文字化け
もじすう	文字数
もじしゅ	文字種
もしき	模式
もじ	文字
もさく	模索
もさ	猛者
もけい	模型
もくろみ	目論見
もくろく	目録
もくろ	目論
もくれい	黙礼
もぐりこ	もぐり込
もくようび	木曜日
もくよう	木曜
もくもく	黙々
もくめ	木目
もくひょう	目標
もくひ	黙秘
もくば	木馬
もくにん	黙認
もくとう	黙祷
もくてきち	目的地
もくてき	目的
もくたん	木炭
もくそく	目測
もくぞう	木造
もくぜん	目前
もくじ	目次
もくし	目視
もくし	目指
もくし	黙視
もくさん	目算
もくさつ	黙殺
もくざい	木材
もくげき	目撃
もくあみ	黙阿弥
もぐ	潜
もく	目
もく	黙
もぎ	模擬
もえ	萌え
もえ	萌
もえ	燃え
もうれつ	猛烈
もうら	網羅
もうもく	盲目
もうまく	網膜
もうまい	蒙昧
もうぼさんせん	孟母三遷
もうふ	毛布
もうひつ	毛筆
もうはつ	毛髪
もうどく	猛毒
もうどうけん	盲導犬
もうとう	毛頭
もうてん	盲点
もうで	詣で
もうちょう	盲腸
もうそうちく	孟宗竹
もうそう	妄想
もうぜん	猛然
もうせん	毛氈
もうじん	盲人
もうしん	盲信
もうしわた	申し渡
もうしわけな	申し訳な
もうしわけ	申し訳
もうしょ	猛暑
もうじゅう	猛獣
もうしゅう	妄執
もうじゃ	亡者
もうしぶん	申し分
もうしで	申し出
もうしつけ	申しつけ
もうしたてしょ	申立書
もうしこみしょ	申込書
もうしこみ	申込
もうしご	申し子
もうしこ	申し込
もうしうけ	申し受け
もうしいれ	申し入れ
もうしあわ	申し合わ
もうしあげ	申し上げ
もうさいかん	毛細管
もうげん	妄言
もうけ	儲け
もうけ	設け
もうきん	猛禽
もうか	儲か
もうい	猛威
もう	申
も	揉
も	漏
も	模
も	燃
も	藻
も	喪
も	盛
も	持
も	洩
めんるい	麺類
めんもく	面目
めんめん	面々
めんみつ	綿密
めんぼく	面目
めんどう	面倒
めんつ	面子
めんだん	面談
めんたいこ	明太子
めんそう	面相
めんそ	免訴
めんそ	免租
めんぜん	面前
めんせつ	面接
めんせき	面積
めんせき	免責
めんぜい	免税
めんしょく	免職
めんじょう	免状
めんじょ	免除
めんしき	面識
めんし	綿糸
めんざい	免罪
めんきょしょう	免許証
めんきょかいでん	免許皆伝
めんきょ	免許
めんかい	面会
めんか	棉花
めんえき	免疫
めん	麺
めん	面
めん	綿
めん	免
めりけんこ	メリケン粉
めやに	目脂
めやす	目安
めもり	目盛り
めもり	目盛
めもと	目元
めもちょう	メモ帳
めめし	女々し
めまぐるし	目まぐるし
めぼし	目星
めべり	目減り
めぶんりょう	目分量
めはな	目鼻
めばえ	芽生え
めのう	碼碯
めど	目処
めっぽう	滅法
めつぼう	滅亡
めったに	滅多に
めった	滅多
めっしつ	滅失
めっきん	滅菌
めっきゃく	滅却
めっき	滅金
めつ	滅
めちゃくちゃ	滅茶苦茶
めだま	目玉
めだ	目立
めせん	目線
めずらし	珍し
めす	牝
めす	雌
めじろ	目白
めじろ	繍眼児
めじるし	目印
めじり	目尻
めしつかい	召使
めした	目下
めし	飯
めざわり	目障り
めざめ	目覚め
めざまし	目覚し
めざと	目ざと
めさき	目先
めざ	目指
めくるめく	目くるめく
めぐりあ	巡り合
めくら	盲
めぐすり	目薬
めぐ	巡
めぐ	恵
めがみ	女神
めがね	眼鏡
めかた	目方
めがしら	目頭
めかけ	妾
めおと	夫婦
めうつり	目移り
めうし	牝牛
めうえ	目上
めいわく	迷惑
めいろう	明朗
めいろ	迷路
めいれい	命令
めいりょう	明瞭
めいよ	名誉
めいもん	名門
めいもく	暝黙
めいもく	名目
めいめいはくはく	明々白々
めいめい	銘々
めいめい	命名
めいぼく	銘木
めいぼう	名望
めいほう	盟邦
めいぼ	名簿
めいぶんか	明文化
めいぶん	名文
めいぶん	名分
めいぶつ	名物
めいふく	冥福
めいふ	冥府
めいびん	明敏
めいび	明媚
めいはく	明白
めいば	名馬
めいにち	命日
めいとう	名答
めいとう	名刀
めいど	明度
めいど	冥土
めいっぱい	目一杯
めいちょ	名著
めいちゅう	命中
めいち	明知
めいだい	命題
めいそう	瞑想
めいせん	名泉
めいせき	明晰
めいせい	名声
めいすう	名数
めいすい	名水
めいじん	名人
めいしん	迷信
めいしょく	明色
めいしょう	名称
めいしょう	名勝
めいしょ	名所
めいしゅ	銘酒
めいしゅ	名手
めいじつ	名実
めいじ	明示
めいし	名詞
めいし	名刺
めいさん	名産
めいさつ	名刹
めいさく	名作
めいさい	迷彩
めいさい	明細
めいこう	名工
めいげん	明言
めいげん	名言
めいけん	名犬
めいけん	名剣
めいげつ	名月
めいきょく	名曲
めいきゅう	迷宮
めいぎ	名義
めいき	銘記
めいき	明記
めいがら	銘柄
めいかく	明確
めいかい	明快
めいかい	明解
めいが	名画
めいか	銘菓
めいか	名家
めいうん	命運
めいう	銘打
めいい	名医
めいあん	明暗
めいあん	名案
めい	暝
めい	滅入
めい	姪
めい	銘
めい	命
めい	名
めあて	目当て
めあたらし	目新し
め	目
め	召
め	眼
め	芽
むろんの	無論の
むろん	無論
むろまち	室町
むろ	室
むれ	蒸れ
むれ	群れ
むれ	群
むるい	無類
むりょく	無力
むりょう	無量
むりょう	無料
むりやり	無理矢理
むりじい	無理強い
むり	無理
むらはちぶ	村八分
むらさき	紫
むらが	群が
むら	村
むら	蒸ら
むよく	無欲
むよう	無用
むゆうびょう	夢遊病
むやみ	無闇
むめい	無銘
むめい	無名
むみ	無味
むま	夢魔
むぼうび	無防備
むぼう	無謀
むほう	無法
むへんかん	無変換
むふう	無風
むひょうじょう	無表情
むびょう	無病
むひ	無比
むはい	無敗
むのう	無能
むねんむそう	無念無想
むねん	無念
むねあげ	棟上げ
むね	棟
むね	旨
むね	胸
むに	無二
むなし	空し
むなし	虚し
むなさわぎ	胸騒ぎ
むなげ	胸毛
むとんちゃく	無頓着
むどく	無毒
むでん	無電
むてっぽう	無鉄砲
むてじゅん	無手順
むてき	無敵
むつまじ	睦まじ
むっつ	六つ
むつき	睦月
むつかし	難し
むつう	無痛
むちん	無賃
むちゅう	夢中
むちゃくちゃ	無茶苦茶
むちゃ	無茶
むち	無知
むち	鞭
むだん	無断
むだ	無駄
むそじ	六十路
むぞうさ	無造作
むそう	夢想
むせんき	無線機
むせん	無銭
むせん	無線
むせっそう	無節操
むせきにん	無責任
むぜい	無税
むせい	無声
むせ	咽
むすめ	娘
むすびつけ	結びつけ
むすびつ	結び付
むすびつ	結びつ
むすこ	息子
むずかし	難し
むすう	無数
むす	結
むしんろん	無神論
むじん	無尽
むじん	無人
むしん	無心
むしろ	蓆
むしろ	筵
むしょく	無色
むしょく	無職
むじょうけん	無条件
むじょうかん	無常観
むじょう	無情
むじょう	無常
むしょう	霧消
むしょう	無性
むしょう	無償
むじゅん	矛盾
むしゅう	無臭
むしゃぶるい	武者震い
むじゃき	無邪気
むしゃ	武者
むしば	虫歯
むしば	蝕
むじな	貉
むじつ	無実
むしけら	虫けら
むしかえ	蒸し返
むしあつ	蒸し暑
むじ	無地
むし	無視
むし	虫
むざん	無残
むざん	無惨
むさん	無産
むさぼ	貪
むさし	武蔵
むざい	無罪
むごん	無言
むこん	無根
むこう	無効
むこう	向こう
むこう	向う
むご	惨
むご	酷
むこ	婿
むげんだい	無限大
むげんえん	無限遠
むげん	無限
むけつ	無欠
むげい	無芸
むけい	無形
むげ	無碍
むけ	向け
むくろ	躯
むくろ	骸
むくどり	椋鳥
むくち	無口
むくい	報い
むく	椋
むく	無垢
むく	浮腫
むぎわら	麦藁
むぎわら	麦ワラ
むきりょく	無気力
むきゅう	無給
むきゅう	無休
むぎばたけ	麦畑
むきどう	無軌道
むぎちゃ	麦茶
むきだ	むき出
むきず	無傷
むきあ	向き合
むぎ	麦
むき	無機
むき	無期
むかん	無冠
むかっぱら	むかっ腹
むかしむかし	昔々
むかしばなし	昔話
むかし	昔
むがく	無学
むかえいれ	迎え入れ
むかえ	迎え
むかいあ	向かい合
むがい	無害
むが	無我
むか	向か
むおん	無音
むえん	無鉛
むえん	無縁
むえき	無益
むいみ	無意味
むいちもん	無一文
むいちぶつ	無一物
むいか	六日
むいか	6日
むいか	６日
むい	無為
む	六
む	無
む	剥
む	蒸
む	向
みんわ	民話
みんよう	民謡
みんゆう	民有
みんぽう	民法
みんぽう	民放
みんな	皆
みんぞく	民族
みんぞく	民俗
みんせい	民生
みんせい	民政
みんしゅく	民宿
みんしゅう	民衆
みんじゅ	民需
みんしゅ	民主
みんじ	民事
みんけん	民権
みんげい	民芸
みんかん	民間
みんか	民家
みんえい	民営
みんい	民意
みわた	見渡
みわけ	見分け
みわく	魅惑
みれん	未練
みるからに	見るからに
みりん	味醂
みりょく	魅力
みりょう	魅了
みりょう	未了
みらい	未来
みより	身寄り
みょうり	冥利
みょうばん	明礬
みょうばん	明晩
みょうねん	明年
みょうにち	明日
みょうちょう	明朝
みょうだい	名代
みょうじょう	明星
みょうしゅ	妙手
みょうじ	名字
みょうじ	苗字
みょうごにち	明後日
みょうぎ	妙技
みょうが	茗荷
みょうが	冥加
みょうあん	妙案
みょう	妙
みやま	深山
みやぶ	見破
みやこ	都
みやげばなし	土産話
みやげ	土産
みゃくらく	脈絡
みゃくはく	脈拍
みゃくどう	脈動
みゃく	脈
みや	宮
みもん	未聞
みもと	身元
みもだえ	身悶え
みめい	未明
みむ	見向
みみより	耳寄り
みみどしま	耳年増
みみざわり	耳障り
みみがくもん	耳学問
みみうち	耳打ち
みみ	耳
みまん	未満
みまわ	見回
みまも	見守
みまね	見まね
みまがえ	見紛え
みまが	見紛
みまいきん	見舞金
みまい	見舞い
みまい	見舞
みほん	見本
みぼうじん	未亡人
みぶん	身分
みぶるい	身震い
みぶり	身振り
みぶり	見ぶり
みひら	見開
みひつ	未必
みはらい	未払い
みはら	見晴ら
みはな	見放
みはから	見計ら
みばえ	見栄え
みは	瞠
みは	見張
みのまわり	身の回り
みのが	見逃
みのうえ	身の上
みのう	未納
みの	稔
みの	蓑
みの	実
みね	嶺
みね	峰
みぬ	見抜
みにく	醜
みにく	見にく
みなれ	見慣れ
みなれ	見なれ
みなり	身なり
みなら	見倣
みなら	見習
みなもと	源
みなも	水面
みなみまわり	南回り
みなみじゅうじせい	南十字星
みなみがわ	南側
みなみ	南
みなと	湊
みなと	港
みなづき	水無月
みなさん	皆さん
みなさま	皆様
みなお	見直
みな	見做
みな	見な
みな	皆
みとりず	見取図
みどり	緑
みとめいん	認印
みとめ	認め
みとどけ	見届け
みどし	巳年
みどころ	見所
みどく	未読
みとおし	見通し
みとお	見通
みとうさ	未踏査
みどう	御堂
みとう	未踏
みと	見取
みと	看取
みていぎ	未定義
みてい	未定
みつりん	密林
みつりょう	密猟
みつりょう	密漁
みつゆ	密輸
みつもりしょ	見積書
みつもり	見積り
みつも	見積も
みつめ	見つめ
みっぺい	密閉
みっぷう	密封
みつばち	蜜蜂
みつばい	密売
みつにゅうこく	密入国
みつどもえ	三つ巴
みつど	密度
みってい	密偵
みっつ	三つ
みっちゃく	密着
みつだん	密談
みつぞろえ	三つ揃え
みつぞう	密造
みっそう	密葬
みっせつ	密接
みっしゅう	密集
みっしつ	密室
みっし	密使
みっこく	密告
みっこう	密航
みつけだ	見つけ出
みつけ	見付け
みつけ	見つけ
みつくろ	見繕
みっきょう	密教
みっかい	密会
みつか	見付か
みつか	見つか
みっか	三日
みっか	3日
みっか	３日
みつ	蜜
みつ	密
みつ	貢
みちゃく	未着
みちびきだ	導き出
みちび	導
みちばた	道端
みちのり	道のり
みちづれ	道連れ
みちすじ	道筋
みちしるべ	道標
みちじゅん	道順
みちしお	満ち潮
みちがえ	見違え
みぢか	身近
みち	路
みち	未知
みち	満ち
みち	道
みち	途
みち	盈ち
みだれ	乱れ
みだら	淫ら
みたて	見立て
みだしなみ	身だしなみ
みだし	見出し
みたけ	身丈
みだ	乱
みだ	見出
みた	満た
みた	充た
みそら	身空
みそめ	見初め
みそに	味噌煮
みそじ	三十路
みそこな	見損な
みそぎ	禊
みそか	晦日
みぞう	未曽有
みぞ	溝
みぞ	渠
みそ	味噌
みそ	晦
みぜんけい	未然形
みぜん	未然
みせもの	見せ物
みせばん	店番
みせつけ	見せつけ
みせじまい	店仕舞い
みせさき	店先
みせかけ	見せかけ
みせいねん	未成年
みせ	店
みせ	見せ
みずむし	水虫
みずまし	水増し
みずほ	瑞穂
みずべ	水辺
みずぶそく	水不足
みずびたし	水浸し
みずひき	水引
みずはけ	水捌け
みずのと	癸
みずのえ	壬
みずどり	水鳥
みずどけい	水時計
みすて	見捨て
みずたま	水玉
みすご	見過ご
みずけ	水気
みずぎわ	水際
みずぎ	水着
みずから	自ら
みずかさ	水かさ
みずかき	水掻き
みすえ	見据え
みずうみ	湖
みずいろ	水色
みずいらず	水入らず
みすい	未遂
みずあらい	水洗い
みずあび	水浴び
みず	瑞
みず	水
みじん	微塵
みしよう	未使用
みじゅく	未熟
みしゅう	未収
みじめ	惨め
みじたく	身支度
みじか	短
みし	見知
みさだめ	見定め
みさげ	見下げ
みさき	岬
みさき	崎
みさかい	見境
みさお	操
みさい	未済
みこん	未婚
みごろし	見殺し
みことのり	勅
みことのり	詔
みごと	見事
みこと	尊
みごたえ	見応え
みごたえ	見ごたえ
みこし	御輿
みこ	御子
みこ	見込
みこ	見越
みけん	眉間
みけつ	未決
みけ	三毛
みぐるし	見苦し
みくらべ	見比べ
みくび	見縊
みくび	見くび
みくだりはん	三下り半
みくだ	見下
みきわめ	見極め
みぎわ	汀
みきり	見切り
みぎめ	右目
みぎはし	右端
みぎて	右手
みぎした	右下
みきき	見聞き
みぎがわ	右側
みぎうで	右腕
みぎうえ	右上
みぎあし	右足
みぎ	右
みき	見切
みき	幹
みかんせい	未完成
みかん	蜜柑
みかん	未完
みかん	未刊
みがわり	身代り
みかわ	見交わ
みがる	身軽
みがら	身柄
みがまえ	身構え
みかね	見兼ね
みかど	帝
みがって	身勝手
みかづき	三日月
みかた	味方
みかた	見方
みかけ	見掛け
みかけ	見かけ
みかくにん	未確認
みかくてい	未確定
みかく	味覚
みかぎ	見限
みかえり	見返り
みかえ	見返
みかいけつ	未解決
みかい	未開
みが	磨
みが	研
みおろ	見下ろ
みおも	身重
みおぼえ	見覚え
みおとり	見劣り
みおと	見落と
みおと	見落
みおさめ	見納め
みおく	見送
みえかくれ	見えかくれ
みえ	見得
みえ	見栄
みえ	見え
みうち	身内
みうしな	見失
みうごき	身動き
みうけ	見受け
みいだ	見出
みい	見入
みあわせ	見合わせ
みあた	見当た
みあげ	見上げ
みあ	見合
み	巳
み	魅
み	満
み	身
み	診
み	実
み	視
み	見
み	観
み	看
まんりょう	満了
まんようがな	万葉仮名
まんよう	万葉
まんゆう	漫遊
まんめん	満面
まんべんな	万遍な
まんびき	万引き
まんねんひつ	万年筆
まんにん	万人
まんなか	真中
まんなか	真ん中
まんてん	満点
まんちょう	満潮
まんだら	曼荼羅
まんぞく	満足
まんぜん	漫然
まんせき	満席
まんせい	慢性
まんすい	満水
まんしん	満身
まんしん	慢心
まんじょう	満場
まんじゅう	饅頭
まんしゃ	満車
まんじどもえ	卍巴
まんしつ	満室
まんじ	卍
まんざい	漫才
まんさい	満載
まんげつ	満月
まんげきょう	万華鏡
まんきつ	満喫
まんき	満期
まんがんぜんせき	満漢全席
まんかんしょく	満艦飾
まんがん	満願
まんがん	満貫
まんがいち	万が一
まんかい	満開
まんが	漫画
まんえん	蔓延
まんえん	万円
まんえつ	満悦
まんいん	満員
まんいち	万一
まん	萬
まん	万
まわりみち	回り道
まわりこ	回り込
まわり	周り
まわり	廻り
まわ	廻
まわ	回
まろやか	円やか
まろうど	客人
まろ	麿
まれ	稀
まれ	希
まるゆう	マル優
まるめこ	丸め込
まるめ	丸め
まるまる	丸々
まるはだか	丸裸
まるだし	丸出し
まるた	丸太
まるぞこ	丸底
まるき	丸木
まる	丸
まりょく	魔力
まり	鞠
まよなか	真夜中
まよ	迷
まゆつば	眉唾
まゆずみ	黛
まゆげ	眉毛
まゆ	繭
まゆ	眉
まやく	麻薬
まもの	魔物
まもう	摩耗
まも	守
まも	護
まめつぶ	豆粒
まめつ	摩滅
まめきゅう	豆球
まめ	豆
まみれ	塗れ
まみなみ	真南
まみず	真水
ままはは	継母
まま	儘
まま	侭
まま	間々
まぼろし	幻
まほうじん	魔方陣
まほう	魔法
まふゆ	真冬
まぶた	瞼
まぶか	目深
まひる	真昼
まひがし	真東
まび	間引
まばら	疎ら
まばゆ	眩
まばたき	瞬き
まばた	瞬
まのび	間延び
まね	真似
まね	招
まぬけ	間抜け
まぬがれ	免れ
まにし	真西
まにあ	間に合
まなびと	学び取
まなでし	愛弟子
まなつ	真夏
まなざし	眼差し
まなこ	眼
まないた	俎
まな	学
まどわ	惑わ
まどり	間取り
まどべ	窓辺
まどぐち	窓口
まどぎわ	窓際
まどがわ	窓側
まどお	間遠
まどう	魔道
まとい	纏
まど	惑
まど	窓
まと	的
まで	迄
まつわ	纏わ
まつろ	末路
まつりごと	政
まつり	祭
まつやま	松山
まつぼっくり	松ぼっくり
まっぷたつ	真っ二つ
まっぴるま	真っ昼間
まっぴつ	末筆
まつび	末尾
まつばら	松原
まつばづえ	松葉杖
まっとう	全う
まっとう	真っ当
まっちゃ	抹茶
まったん	末端
まつたけ	松茸
まったく	全く
まつだい	末代
まっせき	末席
まっせ	末世
まっすぐ	真直
まっすぐ	真っ直
まっしろ	真っ白
まっしょう	末梢
まっしょう	抹消
まつじめ	末締め
まつじつ	末日
まっさつ	抹殺
まっさき	真っ先
まっさお	真っ青
まっさいちゅう	真最中
まっこう	抹香
まっこう	真向
まつご	末期
まつげ	睫毛
まつげ	睫
まっくろ	真っ黒
まっくら	真っ暗
まっき	末期
まっか	真っ赤
まつえい	末裔
まつ	末
まつ	奉
まつ	松
まつ	祭
まちぶせ	待伏せ
まちぶせ	待ち伏せ
まちびと	待人
まちびと	待ち人
まちばり	待針
まちばり	待ち針
まちのぞ	待ち望
まちなみ	町並み
まちなか	町中
まちどおし	待ち遠し
まちぢゅう	町中
まちかど	街角
まぢか	間近
まちが	間違
まちあわ	待ち合わ
まちあいしつ	待合室
まちあい	待合
まちあ	待ち合
まち	町
まち	街
まだら	斑
またた	瞬
またぎき	又聞き
またが	跨
まだ	未だ
また	又
また	跨
また	股
まぜあわせ	混ぜ合わせ
まぜ	混ぜ
ますめ	枡目
ますめ	升目
ますます	益々
まずし	貧し
ますい	麻酔
まず	不味
まず	先ず
ます	鱒
ます	升
ます	益
ましん	麻疹
まじわ	交わ
ましょうめん	真正面
まじょ	魔女
まじゅつ	魔術
ましゃく	間尺
まじめ	真面目
ました	真下
まじえ	交え
まじ	混じ
まじ	交じ
まさゆめ	正夢
まさめ	正目
まさに	正に
まさつ	摩擦
まさしく	正しく
まさき	正木
まざ	混ざ
まざ	交ざ
まさ	優
まさ	勝
まこと	誠
まこと	真
まごころ	真心
まごい	真鯉
まご	孫
まけこ	負け越
まげ	枉げ
まげ	曲げ
まけ	負け
まけ	敗け
まぐろ	鮪
まくらぎ	枕木
まくら	枕
まくした	幕下
まくぎれ	幕切れ
まくうち	幕内
まくあけ	幕開け
まく	膜
まく	幕
まく	捲く
まぎわ	間際
まぎれこ	紛れ込
まぎれ	紛れ
まぎらわし	紛らわし
まぎら	紛ら
まきもの	巻物
まきば	牧場
まきつけ	巻き付け
まきつ	巻き付
まきた	真北
まきじゃく	巻尺
まきこ	巻き込
まきがみ	巻紙
まきかえし	巻き返し
まきえ	蒔絵
まきあげ	巻き上げ
まき	牧
まき	薪
まき	真木
まがりかど	曲り角
まがり	間借り
まがまがし	凶々し
まかふしぎ	摩訶不思議
まかな	賄
まかせ	任せ
まかせ	委せ
まがお	真顔
まかい	魔界
まが	紛
まが	曲が
まが	曲
まか	摩訶
まか	負か
まか	任
まおとこ	間男
まえもって	前もって
まえむき	前向き
まえまえ	前々
まえぶれ	前触れ
まえばらい	前払い
まえば	前歯
まえのめり	前のめり
まえきん	前金
まえがわ	前側
まえがり	前借り
まえがし	前貸し
まえかけ	前掛け
まえがき	前書き
まえおき	前置き
まえうり	前売
まえあし	前足
まえ	前
まうえ	真上
まいよ	毎夜
まいまい	毎々
まいぼつ	埋没
まいばん	毎晩
まいねん	毎年
まいにち	毎日
まいとし	毎年
まいど	毎度
まいつき	毎月
まいぞう	埋蔵
まいそう	埋葬
まいせつ	埋設
まいすう	枚数
まいしん	邁進
まいしゅう	毎週
まいじ	毎時
まいご	迷子
まいこ	舞い込
まいきょ	枚挙
まいき	毎期
まいかい	毎回
まいあさ	毎朝
まい	毎
まい	枚
まい	舞
まい	参
まあたらし	真新し
まーじゃん	麻雀
まあじゃん	麻雀
まあい	間合い
まあい	間合
ま	魔
ま	磨
ま	摩
ま	舞
ま	待
ま	増
ま	真
ま	蒔
ま	撒
ま	捲
ま	間
ま	巻
ほんろう	翻弄
ほんりょう	本領
ほんりゅう	本流
ほんりゅう	奔流
ほんらい	本来
ぼんよう	凡庸
ほんやく	翻訳
ほんや	本屋
ほんもの	本物
ほんもと	本元
ほんもう	本望
ほんめい	本命
ほんむ	本務
ほんみょう	本名
ほんまつてんとう	本末転倒
ほんぽう	本邦
ほんぽう	奔放
ほんぺん	本編
ほんぶん	本文
ぼんぷ	凡夫
ほんぶ	本部
ほんばん	本番
ほんばこ	本箱
ほんば	本場
ほんば	奔馬
ぼんのう	煩悩
ほんのう	本能
ほんねん	本年
ほんね	本音
ほんにん	本人
ほんどおり	本通り
ほんどう	本道
ほんどう	本堂
ほんとう	本当
ほんとう	奔騰
ほんど	本土
ほんてん	本店
ほんちょう	本庁
ぼんち	盆地
ほんだな	本棚
ほんたて	本立
ほんたく	本宅
ほんだい	本題
ほんだい	本代
ほんたい	本体
ほんぞん	本尊
ぼんぞく	凡俗
ほんそく	本則
ほんそう	奔走
ほんせん	本選
ほんせん	本船
ほんせん	本線
ほんせき	本籍
ほんすじ	本筋
ほんすう	本数
ぼんじん	凡人
ほんじん	本陣
ほんしん	本心
ほんしょく	本職
ぼんしょう	梵鐘
ほんしょう	本性
ほんしょう	本章
ほんしょう	本省
ほんしょ	本書
ほんしょ	本署
ほんしゃ	本社
ほんじつ	本日
ほんしつ	本質
ほんしき	本式
ぼんじ	梵字
ほんし	本誌
ほんし	本紙
ほんし	本旨
ほんざん	本山
ぼんさい	盆栽
ぼんさい	凡才
ほんさい	本妻
ほんごし	本腰
ほんごく	本国
ほんこう	本稿
ほんこう	本校
ぼんご	梵語
ほんけん	本件
ほんけ	本家
ぼんくれ	盆暮れ
ほんきょち	本拠地
ほんきょく	本局
ほんぎょう	本業
ほんきょ	本拠
ほんきゅう	本給
ほんぎまり	本決まり
ほんき	本気
ほんがん	本願
ほんかん	本館
ほんかくは	本格派
ほんかく	本格
ほんかいぎ	本会議
ほんかい	本会
ほんか	本科
ぼんおどり	盆踊り
ほんい	本意
ほんい	本位
ほんあん	本案
ぼん	盆
ほん	本
ほろぼ	滅ぼ
ほろび	滅び
ほろび	亡び
ほろ	滅
ほろ	幌
ほれこ	惚れ込
ぼれい	牡蛎
ほれ	惚れ
ほるい	堡塁
ほりょ	捕虜
ほりゅう	保留
ほりだ	掘り出
ほり	堀
ほり	濠
ほり	壕
ぼら	鰡
ぼら	鯔
ほら	洞
ほよう	保養
ほゆう	保有
ほめ	誉め
ほめ	褒め
ほむら	焔
ほまれ	誉れ
ほほえ	微笑
ほぼ	保母
ほほ	頬
ほへい	歩兵
ほふ	屠
ぼひょう	墓標
ほひつ	補筆
ほひつ	補弼
ぼひ	墓碑
ほばく	捕縛
ぼば	牡馬
ほのお	焔
ほのお	炎
ほねやすめ	骨休め
ほねみ	骨身
ほねぶと	骨太
ほねつぎ	骨接ぎ
ほねぐみ	骨組み
ほねお	骨折
ぼね	骨
ほね	骨
ぼにゅう	母乳
ほとんど	殆んど
ほとんど	殆ど
ほとんど	殆
ほととぎす	不如帰
ほどこ	施
ほとけ	仏
ほどうきょう	歩道橋
ほどう	補導
ほどう	歩道
ほどう	舗道
ほど	程
ほど	解
ほてん	補填
ほて	火照
ぼつらく	没落
ほっぽう	北方
ぼっぱつ	勃発
ぼつにゅう	没入
ぼっとう	没頭
ぼっちゃん	坊っちゃん
ほったん	発端
ほっそく	発足
ぼっしゅう	没収
ほっさ	発作
ぼっこん	墨痕
ぼつこせい	没個性
ぼつこうしょう	没交渉
ぼっこう	勃興
ぼっき	勃起
ほっき	発起
ぼつ	没
ぼっ	没
ほっ	欲
ほちょうき	補聴器
ほちょう	歩調
ほちゅう	補注
ぼち	墓地
ぼたん	釦
ぼたん	牡丹
ほたる	蛍
ぼたもち	牡丹餅
ぼだい	菩提
ぼたい	母体
ほだい	補題
ほぞん	保存
ほそめ	細め
ほそぼそ	細々
ほそなが	細長
ほそく	補足
ほそく	補則
ほそく	捕捉
ほそう	舗装
ほそ	細
ぼせん	母船
ほぜん	保全
ほせん	保線
ぼせい	母性
ほせい	補正
ほせい	補整
ほしん	保身
ほしょく	補色
ほじょきん	補助金
ほしょうにん	保証人
ほしょうきん	補償金
ほしょうきん	保証金
ほしょう	堡礁
ほしょう	補償
ほしょう	歩哨
ほしょう	保障
ほしょう	保証
ぼしょ	墓所
ほじょ	補助
ほしゅは	保守派
ぼしゅうだん	母集団
ぼしゅう	募集
ほじゅう	補充
ほしゅう	補習
ほしゅう	補修
ほしゅ	保守
ほしゃく	保釈
ほしぞら	星空
ほしがき	干柿
ほしが	欲しが
ぼし	母子
ぼし	干し
ほじ	保持
ほし	欲し
ほし	星
ぼさつ	菩薩
ほさく	補作
ほさき	穂先
ほさ	補佐
ほころび	綻び
ほころ	綻
ほこらし	誇らし
ぼこく	母国
ぼこう	母港
ぼこう	母校
ほこう	歩行
ぼご	母語
ほご	補語
ほご	保護
ほご	反故
ほご	反古
ほこ	誇
ほけんふ	保健婦
ほけんしょ	保健所
ほけんきん	保険金
ほけん	保険
ほけん	保健
ぼけつ	墓穴
ほけつ	補欠
ほげい	捕鯨
ぼけ	惚け
ほくりく	北陸
ぼくら	僕等
ぼくら	僕ら
ほくよう	北洋
ぼくめつ	撲滅
ほくぶ	北部
ぼくとつ	朴訥
ぼくどう	牧童
ぼくとう	木刀
ほくとう	北東
ほくと	北斗
ぼくちく	牧畜
ほくたん	北端
ぼくたち	僕達
ぼくそう	牧草
ほくせい	北西
ぼくじょう	牧場
ほくじょう	北上
ぼくじゅう	墨汁
ぼくしゅ	墨守
ぼくし	牧師
ぼくさつ	撲殺
ほくげん	北限
ほくぐん	北軍
ほくい	北緯
ぼく	卜
ぼく	僕
ぼきん	募金
ほきん	保菌
ほきょう	補強
ほきゅう	補給
ぼき	簿記
ほき	補記
ぼかん	母艦
ほかん	補間
ほかん	補完
ほかん	保管
ほがらか	朗らか
ほかならぬ	他ならぬ
ほかく	捕獲
ほかく	保革
ぼか	暈
ぼか	簿価
ほか	他
ほか	外
ほおん	保温
ほおぼね	頬骨
ほおべに	頬紅
ほお	頬
ほえ	吠え
ほうわ	飽和
ぼうろん	暴論
ほうろう	放浪
ほうれんそう	菠薐草
ほうれんそう	法蓮草
ぼうれい	亡霊
ほうれい	法令
ぼうりょく	暴力
ほうりゅう	放流
ぼうりゃく	謀略
ほうりつ	法律
ぼうり	暴利
ぼうらく	暴落
ほうらく	崩落
ほうらく	包絡
ぼうよう	芒洋
ほうよう	法要
ほうよう	抱擁
ほうよう	包容
ほうゆう	朋友
ほうやく	邦訳
ぼうや	坊や
ほうもんぎ	訪問着
ほうもん	訪問
ほうもつ	宝物
ほうめん	方面
ほうめん	放免
ぼうめい	亡命
ほうめい	芳名
ほうむ	法務
ほうむ	葬
ほうまん	豊満
ほうまん	放漫
ほうぼく	放牧
ほうぼう	方々
ほうほう	方法
ほうべん	方便
ぼうへき	防壁
ほうべい	訪米
ほうへい	砲兵
ほうぶん	邦文
ほうぶつせん	放物線
ほうふつ	髣髴
ほうふつ	彷彿
ほうふく	報復
ぼうふうう	暴風雨
ぼうふう	防風
ぼうふう	暴風
ぼうふ	防腐
ほうふ	豊富
ほうふ	抱負
ぼうび	防備
ほうび	褒美
ぼうはてい	防波堤
ぼうはつ	暴発
ほうはつ	髣髪
ぼうばく	茫漠
ほうばい	朋輩
ほうはい	澎湃
ほうのう	奉納
ぼうねんかい	忘年会
ほうねん	豊年
ほうねん	放念
ほうにん	放任
ほうにち	訪日
ほうどうじん	報道陣
ぼうどう	暴動
ぼうとう	冒頭
ぼうとう	暴騰
ほうどう	報道
ほうとう	砲塔
ほうとう	放蕩
ほうとう	宝刀
ほうでん	放電
ほうてき	抛擲
ほうてき	法的
ほうてき	放擲
ほうていしき	方程式
ほうてい	法廷
ほうてい	法定
ぼうちょう	膨張
ぼうちょう	傍聴
ほうちょう	包丁
ぼうちゅうざい	防虫剤
ぼうちゅう	傍注
ほうちゅう	訪中
ほうちゃく	逢着
ほうちく	放逐
ほうち	法治
ほうち	放置
ほうち	報知
ぼうだん	防弾
ほうだん	砲弾
ほうだん	放談
ぼうだち	棒立ち
ぼうだい	膨大
ほうだい	邦題
ほうだい	放題
ほうたい	方体
ほうたい	包帯
ほうそく	法則
ほうそうし	包装紙
ほうそうきょく	放送局
ほうそうかい	法曹界
ぼうそう	暴走
ほうそう	放送
ほうそう	包装
ほうそ	硼素
ほうせんか	鳳仙花
ぼうぜん	呆然
ぼうせん	防戦
ほうせん	法線
ほうせつ	包接
ほうせき	宝石
ほうせい	縫製
ほうせい	方正
ぼうすいけい	紡錘形
ぼうすい	防水
ほうすい	放水
ぼうず	坊主
ほうじん	邦人
ほうじん	法人
ほうじん	方陣
ほうしん	方針
ほうしん	放心
ほうしょくひん	宝飾品
ぼうしょく	暴食
ほうしょく	飽食
ほうしょく	宝飾
ほうしょく	奉職
ぼうじょう	棒状
ぼうしょう	傍証
ほうじょう	豊饒
ほうしょう	褒賞
ほうしょう	報賞
ほうしょう	報奨
ほうしょう	報償
ぼうしょ	某所
ほうじょ	幇助
ほうしょ	奉書
ほうじゅん	芳醇
ほうしゅつ	放出
ほうじゅく	豊熟
ぼうしゅうざい	防臭剤
ぼうしゅう	防臭
ほうじゅう	放縦
ほうしゅう	報酬
ぼうじゅ	傍受
ぼうしゅ	芒種
ほうしゃのう	放射能
ほうしゃせん	放射線
ほうしゃせい	放射性
ぼうしゃ	某社
ほうしゃ	放射
ほうしき	方式
ぼうじ	防磁
ぼうし	防止
ぼうし	某氏
ぼうし	帽子
ほうじ	焙じ
ほうじ	法事
ほうし	芳志
ほうし	胞子
ほうし	法師
ほうし	奉仕
ほうさん	硼酸
ほうさん	放散
ぼうさつ	謀殺
ぼうさつ	忙殺
ほうさく	豊作
ほうさく	方策
ぼうさい	防災
ほうこく	報告
ぼうこう	暴行
ほうごう	縫合
ほうこう	彷徨
ほうこう	芳香
ほうこう	方向
ほうこう	放校
ほうこう	奉公
ぼうご	防護
ほうこ	宝庫
ぼうげん	暴言
ぼうけん	冒険
ほうげん	方言
ほうげん	放言
ほうけん	封建
ほうげき	砲撃
ぼうけい	傍系
ほうけい	方形
ほうけ	惚け
ぼうくうごう	防空壕
ぼうくう	防空
ぼうきょう	望郷
ぼうぎょ	防御
ぼうきょ	暴挙
ほうぎょ	崩御
ほうきゅう	俸給
ぼうぎゃく	暴虐
ぼうきゃく	忘却
ほうき	箒
ほうき	蜂起
ほうき	芳紀
ほうき	法規
ほうき	放棄
ほうがんし	方眼紙
ぼうかん	防寒
ぼうかん	暴漢
ぼうかん	傍観
ほうがん	方眼
ほうがん	方丸
ほうがん	包含
ほうかん	幇間
ほうかん	宝冠
ほうかつ	包括
ほうかご	放課後
ほうがくぶ	法学部
ほうがく	邦楽
ほうがく	法学
ほうがく	方角
ほうかいせき	方解石
ほうかいしゃく	法解釈
ぼうがい	望外
ぼうがい	妨害
ほうがい	法外
ほうかい	崩壊
ぼうが	忘我
ぼうか	防火
ほうが	邦画
ほうが	萌芽
ほうが	奉賀
ほうか	邦貨
ほうか	法科
ほうか	放火
ぼうおん	防音
ほうおう	鳳凰
ほうおう	法皇
ほうおう	法王
ぼうえんきょう	望遠鏡
ぼうえん	防炎
ぼうえん	望遠
ぼうえき	防疫
ぼうえき	貿易
ぼうえい	防衛
ほうえい	放映
ぼういん	暴飲
ほういがく	法医学
ほうい	方位
ほうい	包囲
ほうあん	法案
ぼう	棒
ぼう	某
ほう	法
ほう	方
ほう	放
ほう	崩
ほう	奉
ほう	報
ぼいん	拇印
ぼいん	母音
ほいく	保育
ほい	補遺
ほあん	保安
ぼ	戊
ほ	補
ほ	歩
ほ	保
ほ	帆
ほ	彫
ほ	掘
ほ	干
べんろん	弁論
へんろ	遍路
へんれき	遍歴
べんれい	勉励
へんれい	返礼
へんれい	返戻
へんりん	片鱗
べんりし	弁理士
べんり	弁理
べんり	便利
べんらん	便覧
へんよう	変容
べんめい	弁明
べんむかん	弁務官
へんぽん	返本
べんぽう	便法
へんぼう	変貌
べんべつ	弁別
へんぺいそく	扁平足
へんぺい	扁平
へんぷ	返付
へんぴん	返品
べんぴ	便秘
へんぴ	辺鄙
べんぱつ	弁髪
へんのう	返納
へんねん	編年
へんにゅう	編入
べんとう	弁当
へんどう	変動
へんとう	返答
へんてん	変転
へんてこ	変てこ
へんちょう	変調
へんちょう	偏重
へんち	辺地
べんたつ	鞭撻
へんたいがな	変体仮名
へんたい	編隊
へんたい	変態
へんたい	変体
へんそく	変速
へんそく	変則
へんぞう	変造
へんそう	返送
へんそう	変装
へんそう	変奏
へんせん	変遷
へんせい	編成
へんせい	編制
へんせい	変声
へんせい	変成
へんじん	変人
へんしん	返信
へんしん	変身
へんしょく	変色
へんしょく	偏食
べんしょう	弁償
へんじょう	返上
べんじょ	便所
へんしょ	返書
へんしゅうきょう	偏執狂
へんしゅう	編集
へんしゅう	編修
へんしゅう	偏執
へんしつ	変質
へんじ	返事
へんし	変死
へんさん	編纂
べんさい	弁済
へんざい	遍在
へんざい	偏在
へんさい	返済
へんさ	偏差
べんごし	弁護士
へんこうてん	変更点
へんこう	変更
へんこう	偏向
へんこう	偏光
べんご	弁護
へんけん	偏見
べんけい	弁慶
へんけい	変形
へんけい	変型
へんげ	変化
へんくつ	偏屈
へんきん	返金
へんきょく	編曲
べんきょう	勉強
へんきょう	辺境
へんきょう	偏狭
へんきゃく	返却
べんぎじょう	便宜上
べんぎ	便宜
へんかん	返還
へんかん	変換
へんかくかつよう	変格活用
べんがく	勉学
へんかく	変革
へんかく	変格
へんかく	偏角
べんかい	弁解
へんか	変化
べんえき	便益
へんい	変移
へんい	変位
へんあつき	変圧器
へんあつ	変圧
べん	弁
べん	便
へん	辺
へん	編
へん	片
へん	変
へん	偏
へりくだ	遜
へり	縁
へら	箆
へら	減ら
へや	部屋
へび	蛇
べに	紅
べつり	別離
べつもの	別物
べつめい	別名
べつむね	別棟
べっぽう	別報
べつべつ	別々
べっぴん	別嬪
べつびん	別便
べっぴょう	別表
べつばい	別売
べつのう	別納
べっと	別途
べっちゅう	別注
べつだん	別段
べったく	別宅
べっそう	別送
べっそう	別荘
べっせい	別姓
べつじん	別人
べつじょう	別状
べっしょう	別称
べっしゅ	別種
べっしつ	別室
べっし	蔑視
べっし	別紙
べっさつ	別冊
べっこう	別項
べっこ	別個
べっけん	別件
べつくち	別口
べっきょ	別居
べつぎ	別儀
べっき	別記
べっかん	別館
べっかん	別巻
べっかく	別格
べつ	別
へだて	隔て
へだた	隔た
へた	下手
へそまがり	へそ曲がり
へそ	臍
へさき	舳先
へきれき	霹靂
へきめん	壁面
へきとう	劈頭
へきち	僻地
へきそん	僻村
べきしゅうごう	冪集合
へきが	壁画
へきえき	辟易
へき	碧
へき	癖
へき	壁
へき	僻
ぺーじ	頁
へいわ	平和
へいろ	閉路
へいれつ	並列
へいりょく	兵力
へいりつ	並立
へいよう	併用
へいゆう	併有
へいゆ	平癒
へいや	平野
へいもん	閉門
へいめん	平面
へいめい	平明
へいみん	平民
へいまく	閉幕
へいぼん	平凡
へいほう	平方
へいほう	兵法
へいふく	平服
へいふく	平伏
べいはん	米飯
へいばん	平板
へいはん	平版
へいはつ	併発
へいばい	併売
へいねん	平年
へいねつ	平熱
へいどん	併呑
へいてん	閉店
へいてん	弊店
へいてい	閉廷
へいてい	平定
へいちょう	閉庁
へいち	並置
へいち	平地
へいたん	平坦
へいたい	兵隊
へいそん	併存
へいそく	閉塞
へいそ	平素
へいぜん	平然
へいせつ	併設
へいせい	平静
へいしん	並進
へいしん	平身
べいしょく	米食
へいじょう	閉場
へいじょう	平常
へいしょ	閉所
へいしゅうごう	閉集合
べいじゅ	米寿
へいしゃ	弊社
へいしゃ	兵舎
へいじつ	平日
べいしきしゅうきゅう	米式蹴球
へいじ	平時
へいし	兵士
へいざん	閉山
べいさく	米作
へいさ	閉鎖
へいこうせん	平行線
へいこうしへんけい	平行四辺形
へいごう	併合
へいこう	閉校
へいこう	閉口
へいこう	並行
へいこう	平衡
へいこう	平行
へいこう	併行
へいげん	平原
へいげい	睥睨
へいけい	閉経
へいけ	平家
べいぐん	米軍
へいきんてん	平均点
へいきんち	平均値
へいきん	平均
へいき	平気
へいき	兵器
へいき	併記
へいかん	閉館
へいがい	弊害
へいかい	閉会
べいか	米価
へいか	陛下
へいか	平価
へいおん	平穏
へいえき	兵役
へいえい	併映
へいい	平易
へいあん	平安
へい	塀
へい	兵
へい	丙
へ	減
へ	経
ぶんれつ	分裂
ぶんれい	文例
ぶんるい	分類
ぶんりょう	分量
ぶんりつ	分立
ぶんり	分離
ぶんらく	文楽
ぶんよ	分与
ぶんや	分野
ぶんめん	文面
ぶんめい	文明
ぶんみん	文民
ぶんみゃく	文脈
ふんまん	噴懣
ぶんまつ	文末
ふんまつ	粉末
ぶんぼうぐ	文房具
ぶんぽう	文法
ぶんぼ	分母
ぶんべん	分娩
ぶんべつ	分別
ふんべつ	分別
ふんぷん	紛々
ぶんぶつ	文物
ぶんぷ	分布
ぶんぶ	文武
ぶんぴつ	文筆
ぶんぴつ	分筆
ぶんぴつ	分泌
ふんぱん	噴飯
ふんぱつ	奮発
ぶんぱい	分配
ぶんぱ	分派
ふんば	踏ん張
ぶんのう	分納
ふんにゅう	粉乳
ふんどし	褌
ふんどう	分銅
ふんとう	奮闘
ぶんつう	文通
ぶんちゅう	文中
ぶんち	分置
ぶんだん	文壇
ぶんだん	分断
ぶんたん	分担
ぶんたい	文体
ぶんたい	分隊
ふんぞりかえ	ふんぞり返
ふんそう	紛争
ふんそう	扮装
ふんぜん	奮然
ふんぜん	憤然
ぶんせつ	文節
ぶんせつ	分節
ぶんせき	文責
ぶんせき	分析
ぶんすう	分数
ぶんすいれい	分水嶺
ふんすい	噴水
ぶんしん	分身
ふんしょく	粉飾
ぶんじょう	分譲
ぶんしょう	文章
ぶんしょ	文書
ふんしょ	焚書
ふんしゅつ	噴出
ぶんしゅう	文集
ぶんしゃ	分社
ふんしゃ	噴射
ぶんしつ	分室
ふんしつ	紛失
ぶんし	分詞
ぶんし	分子
ぶんさん	分散
ぶんさつ	分冊
ぶんさい	文才
ふんさい	粉砕
ぶんこつ	分骨
ぶんごう	文豪
ぶんこう	分校
ぶんご	文語
ぶんこ	文庫
ぶんけん	文献
ぶんげい	文藝
ぶんげい	文芸
ぶんけい	文系
ぶんけい	文型
ぶんけ	分家
ぶんぐ	文具
ぶんぎょう	分業
ぶんきょう	文教
ぶんき	分岐
ふんぎ	ふん切
ふんき	奮起
ふんき	噴気
ぶんかん	文官
ぶんかん	分館
ぶんかつ	分割
ぶんかざい	文化財
ぶんがくぶ	文学部
ぶんがく	文學
ぶんがく	文学
ぶんかい	分解
ぶんかい	分会
ふんがい	憤慨
ぶんか	文科
ぶんか	文化
ぶんか	分科
ぶんか	分化
ふんか	噴火
ぶんえん	分煙
ふんえん	噴煙
ふんいき	雰囲気
ぶんい	文意
ぶん	文
ぶん	分
ふん	糞
ふん	扮
ふん	憤
ふん	分
ふわらいどう	付和雷同
ふわたり	不渡り
ふわく	不惑
ふわ	不和
ふろしき	風呂敷
ふろく	付録
ふろう	浮浪
ふろう	不老
ふろう	不労
ぶろ	風呂
ふろ	風呂
ふれんぞく	不連続
ふれこ	触れ込
ぶれいこう	無礼講
ぶれい	無礼
ふれあい	ふれ合い
ふれあ	触れ合
ふれ	触れ
ふるわ	震わ
ふるや	古屋
ふるめかし	古めかし
ふるまい	振舞
ふるま	振る舞
ふるほん	古本
ふるび	古び
ふるて	古手
ふるす	古巣
ふるさと	古里
ふるくさ	古くさ
ふるぎ	古着
ふるえあが	震え上が
ふるえ	震え
ふるいわけ	ふるい分け
ふるいた	奮い立
ふるいおと	ふるい落と
ふるいおこ	奮い起こ
ぶるい	部類
ふるい	篩
ふる	篩
ふる	奮
ふる	震
ふる	振る
ふる	古
ふる	旧
ふりん	不倫
ふりわけ	振り分け
ぶりょく	武力
ふりょく	浮力
ふりょう	不良
ふりょう	不漁
ふりょ	不慮
ふりむ	振り向
ふりみだ	振り乱
ふりまわ	振り回
ふりま	振りま
ふりはら	振り払
ふりつけ	振付け
ふりつ	府立
ふりだし	振出
ふりだ	振り出
ふりだ	降り出
ふりそで	振袖
ふりそそ	降り注
ふりこみ	振込
ふりこ	振り込
ふりき	振り切
ふりがな	振り仮名
ふりかた	振り方
ふりかけ	振りかけ
ふりかか	降り掛か
ぶりかえ	ぶり返
ふりかえ	振替
ふりかえ	振り返
ふりかえ	振り替え
ふりえき	不利益
ぶり	鰤
ふり	不利
ふらん	腐乱
ふらん	不乱
ぶらさげ	ぶら下げ
ぶらさが	ぶら下が
ぶらく	部落
ぶらうんかん	ブラウン管
ぶらい	不頼
ふようど	腐葉土
ぶようじん	不用心
ふようい	不用意
ぶよう	舞踊
ふよう	浮揚
ふよう	扶養
ふよう	不要
ふよう	不用
ふよ	付与
ふゆやま	冬山
ふゆやすみ	冬休み
ふゆもの	冬物
ふゆふく	冬服
ふゆば	冬場
ふゆきとどき	不行届き
ふゆかい	不愉快
ふゆう	浮遊
ふゆう	富裕
ふゆ	冬
ふや	増や
ふや	殖や
ぶもん	部門
ふもん	不問
ふもと	麓
ふもう	不毛
ふめん	譜面
ふめつ	不滅
ふめいりょう	不明瞭
ふめいよ	不名誉
ふめいかく	不明確
ふめい	不明
ふむき	不向き
ふみん	不眠
ふみはず	踏み外
ふみにじ	踏みにじ
ふみとどま	踏みとどま
ふみつけ	踏みつけ
ふみづき	文月
ふみたお	踏み倒
ふみだい	踏台
ふみだ	踏み出
ふみこ	踏み込
ふみきり	踏切
ふみき	踏み切
ふみえ	踏み絵
ふみ	文
ふまん	不満
ふまえ	踏まえ
ふほんい	不本意
ふほう	訃報
ふほう	不法
ふぼ	父母
ふべん	不便
ふへん	普遍
ふへん	不変
ぶべつ	侮蔑
ふへい	不平
ぶぶん	部分
ふふく	不服
ふぶき	吹雪
ぶふうりゅう	無風流
ぶひん	部品
ふびん	不憫
ふびょうどう	不平等
ふひょう	歩兵
ふひょう	附票
ふひょう	付表
ふひょう	不評
ふひつよう	不必要
ぶひ	部費
ふび	不備
ふはつ	不発
ふはい	腐敗
ふはい	不敗
ふのう	不能
ふねん	不稔
ふねん	不燃
ぶね	船
ふね	船
ふね	舟
ふぬけ	腑抜け
ふにん	赴任
ふにん	不妊
ふにく	腐肉
ぶなん	無難
ふなれ	不慣れ
ふなよい	船酔い
ふなむし	舟虫
ふなびん	船便
ふなのり	船乗り
ふなに	船荷
ふなで	船出
ふなたび	船旅
ふなぞこ	船底
ふなくぎ	舟釘
ぶない	部内
ふない	府内
ぶな	椈
ぶな	山毛欅
ふな	鮒
ふとん	布団
ふとん	蒲団
ふとめ	太め
ぶどまり	歩留り
ぶどまり	歩留まり
ふとっぱら	太っ腹
ふとじ	太字
ふところで	懐手
ふところ	懐
ふとくい	不得意
ふとく	不徳
ふどうとく	不道徳
ふどうたい	不導体
ふどうさん	不動産
ぶどう	葡萄
ぶどう	武道
ふどう	浮動
ふどう	不同
ふどう	不動
ふとう	埠頭
ふとう	不等
ふとう	不当
ふと	太
ふでまめ	筆まめ
ふでぶしょう	筆不精
ふてぎわ	不手際
ふてきせつ	不適切
ふでき	不出来
ふてき	不適
ふてき	不敵
ふてい	不逞
ふてい	不定
ふてい	不貞
ふで	筆
ぶつりょう	物量
ぶつりょう	物療
ぶつりがく	物理学
ぶつり	物理
ぶつめつ	仏滅
ぶっぴん	物品
ぶっとお	ぶっ通
ぶつどう	仏道
ふっとう	沸騰
ぶっと	ぶっ飛
ふっと	ふっ飛
ふってん	沸点
ぶってき	物的
ふってい	払底
ふつつか	不束
ぶっちょうづら	仏頂面
ぶつだん	仏壇
ぶったぎ	ぶった切
ぶったい	物体
ぶっだ	仏陀
ぶつぞう	仏像
ぶっそう	物騒
ぶっせい	物性
ぶっしん	物心
ぶっしん	仏心
ぶっしょく	物色
ふっしょく	払拭
ぶっしょう	物証
ぶっしつ	物質
ぶっし	物資
ぶっし	仏師
ぶっさん	物産
ふっこく	復刻
ふつごう	不都合
ふっこう	復交
ふっこう	復興
ふっこ	復古
ぶっけん	物件
ふっけん	復権
ふっきん	腹筋
ぶっきょう	仏教
ふっきゅう	復旧
ふっきゅう	復仇
ぶつぎ	物議
ふづき	文月
ふっき	復帰
ふっき	吸っ切
ふっき	ふっ切
ふつかよい	宿酔い
ふっかつ	復活
ふっかけ	吸っ掛け
ふっかけ	ふっ掛け
ぶっかく	仏閣
ぶっか	物価
ふつか	二日
ふつか	2日
ふつか	２日
ふつう	普通
ふつう	不通
ぶつ	物
ぶちょう	部長
ふちょう	符丁
ふちょう	府庁
ふちょう	婦長
ふちょう	不調
ふちゅうい	不注意
ふちゃく	付着
ぶち	斑
ふち	淵
ふち	付置
ふち	縁
ふだんぎ	普段着
ふだん	普段
ふだん	不断
ふたん	負担
ふたりして	二人して
ふたり	二人
ふたば	双葉
ぶたにく	豚肉
ふたつ	二つ
ふたたび	再び
ふたご	双子
ふたく	負託
ふたく	付託
ふたえ	二重
ぶたい	部隊
ぶたい	舞台
ふだい	譜代
ふたい	付帯
ぶた	豚
ふだ	札
ふた	蓋
ふそん	不遜
ふそん	不尊
ふぞろい	不揃い
ふそくふり	不即不離
ぶぞく	部族
ぶそく	不足
ふぞく	附属
ふぞく	付属
ふそく	附則
ふそく	付則
ふそく	不足
ふそうおう	不相応
ぶそう	武装
ふそ	父祖
ふせんぱい	不戦敗
ふせんしょう	不戦勝
ふぜん	不全
ふせん	付箋
ふせん	不戦
ふせつ	敷設
ふせつ	付設
ふせじ	伏字
ふせじ	伏せ字
ふせき	布石
ふせいりつ	不成立
ふぜい	風情
ふせい	不斉
ふせい	不正
ふせい	不整
ふせい	不省
ふせ	防
ふせ	伏せ
ふせ	布施
ふせ	臥せ
ふすま	襖
ぶすう	部数
ふすう	負数
ぶすい	不粋
ふずい	付随
ふずい	不随
ふず	付図
ふしんにん	不信任
ふしんせつ	不親切
ふじん	婦人
ふじん	夫人
ふしん	腐心
ふしん	普請
ふしん	不振
ふしん	不審
ふしん	不信
ふじょし	婦女子
ふしょくふ	不織布
ぶじょく	侮辱
ふしょく	腐食
ふしょうふずい	夫唱婦随
ふしょうじ	不祥事
ぶしょう	武将
ぶしょう	不精
ふじょう	浮上
ふじょう	不浄
ふしょう	負傷
ふしょう	不詳
ぶしょ	部署
ぶしょ	部所
ふじょ	扶助
ふじょ	婦女
ふじゅん	不順
ふじゅん	不純
ふしゅび	不首尾
ふしゅつ	不出
ふじゅうぶん	不十分
ふじゅうぶん	不充分
ふじゆう	不自由
ふしゅう	腐臭
ぶしゅ	部首
ふしゃ	富者
ふしめ	節目
ふじみ	不死身
ふしまつ	不始末
ふしぶし	節々
ぶしつけ	不躾
ぶしつ	部室
ふしちょう	不死鳥
ふじちゃく	不時着
ふしぜん	不自然
ふしぎ	不思議
ふしあわせ	不幸せ
ぶじ	無事
ぶし	武士
ふじ	不治
ふじ	不時
ふじ	藤
ふし	節
ふさんせい	不賛成
ふさんか	不参加
ふさわし	相応し
ぶざま	不様
ぶさほう	無作法
ふさく	不作
ふさが	塞が
ふさいよう	不採用
ぶさいく	不細工
ふざい	不在
ふさい	負債
ふさい	夫妻
ふさ	房
ふさ	塞
ぶこつ	武骨
ふこころえ	不心得
ふこくきょうへい	富国強兵
ぶこく	誣告
ふこく	布告
ふごうり	不合理
ふこうへい	不公平
ふごうかく	不合格
ふごう	符合
ふごう	符号
ふごう	富豪
ふこう	不幸
ふこう	不孝
ふけんぜん	不健全
ふけんこう	不健康
ふげん	付言
ふけん	府県
ふけつ	不潔
ふけこ	老け込
ふけいざい	不経済
ふけいき	不景気
ふけい	父兄
ふけい	婦警
ふけ	老け
ふけ	耽
ふけ	更け
ふくろこうじ	袋小路
ふくろおび	袋帯
ふくろう	梟
ぶくろ	袋
ふくろ	復路
ふくろ	袋
ふくれ	膨れ
ふくり	複利
ふくり	福利
ふくら	膨ら
ふくようき	複葉機
ふくよう	服用
ふくやく	服薬
ふくめん	覆面
ふくめ	含め
ふくむ	服務
ふくまく	腹膜
ふくほん	複本
ふくほん	副本
ふくへい	伏兵
ふくびき	福引
ふくどく	服毒
ふくどく	副読
ふくつう	腹痛
ふくつ	不屈
ふぐたいてん	不倶載天
ふくだい	副題
ふくそすう	複素数
ふくぞく	服属
ふくそう	輻輳
ふくそう	服装
ふくせん	複線
ふくせん	伏線
ふくせい	複製
ふくすうこ	複数個
ふくすう	複数
ふくすい	覆水
ふくじんづけ	福神漬
ふくしん	腹心
ふくしん	副審
ふくしょく	服飾
ふくしょく	復職
ふくしょく	副食
ふくしょう	複勝
ふくしょう	復唱
ふくしょう	副賞
ふくしょう	副将
ふくじゅう	服従
ふくしゅう	復讐
ふくしゅう	復習
ふくしゃ	複写
ふくしき	複式
ふくしき	腹式
ふくじ	服地
ふくじ	副次
ふくし	福祉
ふくし	副詞
ふくさんぶつ	副産物
ふくさよう	副作用
ふくざつ	複雑
ふくさい	副菜
ふくごう	複合
ふくごう	復号
ふくげん	復元
ふくぎょう	副業
ふくかん	副官
ふくがく	復学
ふくえん	復縁
ふくえき	服役
ふぐう	不遇
ふくいん	福音
ふぐあい	不具合
ふぐ	鰒
ふぐ	河豚
ふく	福
ふく	服
ふく	復
ふく	伏
ふく	含
ふきんしん	不謹慎
ふきんこう	不均衡
ふきん	布巾
ふきん	付近
ぶきりょう	不器量
ぶきょく	部局
ぶぎょう	奉行
ぶきよう	不器用
ふきょう	布教
ふきょう	不況
ふきゅう	普及
ふきゅう	不朽
ふきゅう	不休
ぶきみ	不気味
ふきぬけ	吹抜け
ふきなが	吹き流
ふきとば	吹き飛ば
ふきと	拭き取
ふきでもの	吹出物
ふきつけ	吹き付け
ふきつ	不吉
ふきだまり	吹き溜り
ふきだ	吹き出
ふきそく	不規則
ふきそ	不起訴
ふきこ	吹き込
ふきげん	不機嫌
ふきかけ	吹きかけ
ふきかえ	吹替え
ふきかえ	吹き返
ふきあれ	吹き荒れ
ぶき	武器
ふぎ	付議
ふぎ	不義
ふき	蕗
ふき	附記
ふき	付記
ふかんぜん	不完全
ふかんしょう	不感症
ふかんしょう	不干渉
ぶかん	武官
ふかん	俯瞰
ふかめ	深め
ふかま	深ま
ふかぶん	不可分
ふかぶかと	深々と
ふかひ	不可避
ふかのう	不可能
ふかつ	賦活
ぶかちょう	部課長
ふかち	不可知
ふかしん	不可侵
ふかしぎ	不可思議
ふかけつ	不可欠
ふかく	俯角
ふかく	不覚
ふかぎゃく	不可逆
ふかかい	不可解
ぶがいひ	部外秘
ぶがい	部外
ぶかい	部会
ふかい	不快
ぶか	部下
ふか	鱶
ふか	鯊
ふか	負荷
ふか	府下
ふか	付加
ふか	不可
ふか	深
ふか	蒸か
ふか	更か
ふおん	不穏
ぶえんりょ	無遠慮
ふえん	敷衍
ふえて	不得手
ふえい	府営
ふえ	笛
ふえ	増え
ふえ	殖え
ふうん	不運
ふうりん	風鈴
ふうりょく	風力
ふうりゅう	風流
ふうみ	風味
ふうぼう	風防
ふうぼう	風貌
ふうぶつし	風物詩
ふうぶつ	風物
ふうふ	夫婦
ふうどう	風洞
ふうとう	封筒
ふうど	風土
ふうてい	風体
ふうちょう	風潮
ふうたい	風袋
ふうぞく	風俗
ふうそく	風速
ふうせん	風船
ふうせつ	風雪
ふうしん	風疹
ふうしょ	封書
ふうしゅう	風習
ふうしゃ	風車
ふうじこめ	封じ込め
ふうじこ	封じ込
ふうし	諷刺
ふうし	風刺
ふうさつ	封殺
ふうさい	風采
ふうさ	封鎖
ふうこう	風向
ふうこう	風光
ふうけい	風景
ふうきり	封切り
ふうきょう	風狂
ふうぎ	封切
ふうき	風紀
ふうき	封切
ふうき	富貴
ふうがわり	風変わり
ふうかく	風格
ふうが	風雅
ふうか	風化
ふううん	風雲
ふうう	風雨
ふういん	封印
ふうあつ	風圧
ふう	風
ふう	封
ぶいん	部員
ふいっち	不一致
ふいちょう	吹聴
ふい	不意
ふあんてい	不安定
ふあん	不安
ぶあつ	分厚
ぶあいそう	無愛想
ぶあい	歩合
ぶ	分
ぶ	部
ふ	麸
ふ	噴
ふ	伏
ふ	葺
ふ	附
ふ	賦
ふ	負
ふ	譜
ふ	符
ふ	府
ふ	付
ふ	踏
ふ	践
ふ	吹
ふ	振
ふ	拭
ふ	降
ふ	臥
びんわん	敏腕
びんらん	便覧
ひんもく	品目
ひんめい	品名
ひんみん	貧民
びんぼう	貧乏
ひんぷ	貧富
ひんぱん	頻繁
ひんぱつ	頻発
ひんば	牝馬
ひんど	頻度
びんぞこ	瓶底
びんそく	敏速
ひんそう	貧相
びんせん	便箋
ひんせい	品性
びんじょう	便乗
びんしょう	憫笑
びんしょう	敏捷
ひんしゅつ	頻出
ひんしゅく	顰蹙
ひんしゅ	品種
ひんじゃく	貧弱
ひんじゃ	貧者
ひんしつ	品質
ひんし	瀕死
ひんし	品詞
ひんこん	貧困
ひんこう	品行
ひんけつ	貧血
ひんきゅう	殯宮
ひんきゅう	貧窮
ひんきゃく	賓客
びんかん	敏感
ひんかく	品格
ひんい	品位
びん	壜
びん	便
びん	瓶
ひん	貧
ひん	瀕
ひん	品
ひわれ	干割れ
ひわり	日割
びわ	琵琶
ひわ	秘話
ひろめ	広め
ひろま	広間
ひろま	広ま
ひろびろ	広々
ひろば	広場
ひろげ	広げ
ひろが	広が
ひろうえん	披露宴
びろう	尾篭
ひろう	疲労
ひろう	披露
ひろ	汎
ひろ	拾
ひろ	広
ひれん	悲恋
ひれふ	ひれ伏
ひれつ	卑劣
ひれき	披瀝
ひれい	比例
ひれ	鰭
ひるやすみ	昼休み
ひるめし	昼飯
ひるま	昼間
ひるね	昼寝
ひるげ	昼餉
ひるがえ	翻
ひるい	比類
ひる	蛭
ひる	昼
ひる	怯
びりょく	微力
ひりょく	臂力
ひりょく	非力
びりょう	微量
ひりょう	肥料
びりゅう	微粒
ひりつ	比率
ひりき	非力
ひらめ	鮃
ひらめ	閃
ひらた	平た
ひらぞこ	平底
ひらきなお	開き直
ひらきなお	開きなお
ひらがな	平仮名
ひらおよぎ	平泳ぎ
ひらいしん	避雷針
ひらい	避雷
ひらあやまり	平謝り
ひら	開
ひよわ	ひ弱
びより	日和
ひより	日和
ひよどり	鵯
びよく	尾翼
ひよく	肥沃
ひょうろん	評論
ひょうろう	兵糧
びょうれき	病歴
ひょうりゅう	漂流
びょうり	病理
ひょうり	表裏
ひょうめんは	表面波
ひょうめん	表面
びょうめい	病名
ひょうめい	表明
びょうま	病魔
ひょうほん	標本
びょうぼつ	病没
ひょうぼう	標榜
ひょうへん	豹変
びょうぶ	屏風
ひょうひ	表皮
ひょうばん	評判
ひょうはく	漂白
ひょうはく	漂泊
びょうにん	病人
びょうどう	平等
びょうとう	病棟
ひょうど	表土
ひょうでん	評伝
ひょうでん	票田
ひょうてん	評点
ひょうてん	氷点
びょうてき	病的
ひょうてき	標的
ひょうてい	評定
ひょうてい	標定
ひょうちゃく	漂着
ひょうたん	瓢箪
ひょうだい	表題
びょうそく	秒速
ひょうそく	平仄
びょうそう	病巣
ひょうそう	表層
ひょうせつ	剽窃
びょうしん	秒針
びょうしん	病身
びょうじょう	病状
びょうしょう	病床
ひょうじょう	評定
ひょうじょう	表情
ひょうしょう	表象
ひょうしょう	表彰
ひょうじゅんけい	標準形
ひょうじゅんか	標準化
ひょうじゅん	標準
ひょうしゅつ	表出
びょうじゃく	病弱
ひょうしゃく	評釈
びょうしゃ	描写
びょうしつ	病室
ひょうしき	標識
びょうし	病死
ひょうじ	表示
ひょうし	表紙
ひょうし	拍子
ひょうざん	氷山
ひょうさつ	表札
ひょうこう	標高
ひょうご	標語
びょうげんきん	病源菌
びょうげんきん	病原菌
びょうげん	病原
ひょうげん	評言
ひょうげん	表現
ひょうげん	氷原
びょうけつ	病欠
ひょうけつ	表決
ひょうけつ	票決
ひょうけい	表敬
ひょうきん	剽軽
びょうき	病気
ひょうぎ	評議
ひょうき	表記
ひょうき	標記
ひょうかん	慓悍
ひょうかい	氷解
びょうが	描画
ひょうが	氷河
ひょうか	評価
ひょうおん	表音
びょういん	病院
ひょうい	憑依
ひょうい	表意
びよう	美容
びょう	鋲
びょう	秒
ひよう	費用
ひょう	雹
ひょう	豹
ひょう	評
ひょう	表
ひょう	票
ひょう	氷
ひょう	標
ひゆうり	非有理
ひゆ	比喩
ひややっこ	冷奴
ひややか	冷やか
ひやむぎ	冷麦
ひゃっかりょうらん	百花繚乱
ひゃっかてん	百貨店
ひゃっか	百科
ひやけ	日焼け
びゃくや	白夜
ひゃくめんそう	百面相
ひゃくぶんりつ	百分率
ひゃくぶん	百聞
ひゃくしょう	百姓
びやく	媚薬
ひやく	飛躍
ひゃく	百
ひやか	冷やか
ひやあせ	冷汗
ひや	冷や
ひもの	干物
ひもと	火元
ひもく	費目
ひも	紐
ひめん	罷免
びめい	美名
ひめい	悲鳴
ひめ	姫
ひめ	秘め
びみょう	微妙
ひみつ	秘密
びまん	瀰漫
ひまん	肥満
ひまわり	向日葵
ひまつ	飛抹
ひましゆ	ひまし油
ひまく	皮膜
ひま	暇
ひぼん	非凡
びぼうろく	備忘録
びぼう	美貌
ひぼう	誹謗
ひほう	秘法
ひほう	秘宝
ひほう	悲報
ひへい	疲弊
ひぶん	非文
ひふん	悲憤
ひぶた	火蓋
ひふく	被服
ひぶ	日歩
ひふ	皮膚
びひん	備品
ひびわれ	ひび割れ
ひひょう	批評
びびし	美々し
ひびか	響か
びび	微々
ひび	日々
ひび	響
ひばん	非番
ひはん	批判
ひばり	雲雀
ひばな	火花
ひばち	火鉢
ひばしら	火柱
ひばく	被曝
ひのと	丁
ひので	日の出
ひのこ	火の粉
ひのき	桧
ひのえ	丙
びねつ	微熱
ひね	捻
ひにん	避妊
ひにん	否認
ひにょうき	泌尿器
ひにょう	泌尿
ひにち	日日
ひにち	日にち
ひにく	皮肉
びなん	美男
ひなん	非難
ひなん	避難
ひなわじゅう	火縄銃
ひなた	日向
ひな	雛
ひとりぼっち	一人ぼっち
ひとりっこ	一人っ子
ひとりじめ	独り占め
ひとりじめ	一人占め
ひとりごと	独り言
ひどり	日取り
ひとり	独り
ひとり	一人
ひとみ	瞳
ひとまわり	一回り
ひとまく	一幕
ひとまえ	人前
ひとびと	人々
ひとびと	人びと
ひとばん	一晩
ひとはだ	人肌
ひとはだ	一肌
ひとなみ	人並
ひととき	一時
ひととおり	一通り
ひとで	人出
ひとで	人手
ひとづま	人妻
ひとつ	一つ
ひとちがい	人違い
ひとたび	一度
ひとたち	人達
ひとすじなわ	一筋縄
ひとすじ	一筋
ひとしなみ	等し並み
ひとじち	人質
ひとし	等し
ひとし	均し
ひとさわがせ	人騒がせ
ひとさらい	人攫い
ひとさらい	人拐い
ひとざと	人里
ひとさしゆび	人差指
ひところ	一頃
ひとごみ	人混み
ひとごみ	人込み
ひとごと	他人事
ひとごと	人事
ひとこと	一言
ひどけい	日時計
ひとくち	一口
びとく	美徳
ひとく	秘匿
ひとぎき	人聞き
ひとがら	人柄
ひとかたならぬ	一方ならぬ
ひとかたならず	一方ならず
ひとかげ	人影
ひとえ	単
ひとえ	一重
ひどうき	非同期
ひとう	秘湯
ひといちばい	人一倍
ひとあし	一足
ひど	酷
ひと	他人
ひと	人
びてん	美点
ひでん	秘伝
ひでり	日照り
ひてつ	非鉄
びてき	美的
ひてい	否定
ひつよう	必要
ひづめ	蹄
ひっぱり	引張
ひっぱく	逼迫
ひっぱ	引っ張
ひつどく	必読
ひっとう	筆頭
ひってき	匹敵
ひっちょう	必聴
ひっちゅう	必中
ひっちゃく	必着
ひっち	筆致
ひつだん	筆談
ひっそく	逼塞
ひつぜん	必然
ひつぜつ	筆舌
ひっせき	筆跡
ひっせい	畢生
ひっす	必須
ひつじょう	必定
ひっしょう	必勝
ひつじゅん	筆順
ひっしゅう	必修
ひつじゅ	必需
ひっしゃ	筆者
ひっしゃ	筆写
ひつじどし	未年
ひつじ	羊
ひつじ	未
ひっし	必至
ひっし	必死
ひっさつ	必殺
ひっこみ	引込み
ひっこし	引越し
ひっこう	筆耕
ひっこ	引っ込
ひっこ	引っ越
ひっけん	必見
ひっけい	必携
ひづけ	日付
ひっくるめ	引っくるめ
ひっくりかえ	ひっくり返
ひっきょう	畢竟
ひつぎ	棺
ひっき	筆記
ひっかけ	引っかけ
ひっかか	引っかか
ひっか	筆禍
ひっか	引っか
ひつう	悲痛
ひつあつ	筆圧
ひちゅう	秘中
ひだんけいし	避弾経始
びだん	美談
ひたん	悲嘆
ひだりめ	左目
ひだりて	左手
ひだりした	左下
ひだりがわ	左側
ひだりうで	左腕
ひだりうえ	左上
ひだりあし	左足
ひだり	左
ひだまり	日溜り
ひだち	肥立ち
ひだい	肥大
ひたい	額
ひだ	襞
ひた	浸
ひそめ	顰め
ひそめ	潜め
びそく	微速
ひぞく	卑属
ひぞく	卑俗
ひそか	密か
ひそか	秘か
ひそか	窃か
ひぞう	脾臓
ひぞう	秘蔵
ひそう	皮相
ひそう	悲壮
ひそ	顰
ひそ	砒素
ひそ	潜
ひせんけい	非線形
ひせん	卑賤
ひせん	卑賎
ひぜに	日銭
びせきぶん	微積分
ひず	歪
びじん	美人
びしん	微震
ひじり	聖
びしょく	美食
ひじょうしき	非常識
ひじょうぐち	非常口
びしょう	微笑
びしょう	微小
ひじょう	非情
ひじょう	非常
ひしょう	飛翔
びじょ	美女
ひしょ	避暑
ひしょ	秘書
ひじゅん	批准
びじゅつかん	美術館
びじゅつ	美術
ひじゅつ	秘術
びしゅう	美醜
ひじゅう	比重
びしゅ	美酒
ひしゃたい	被写体
びじゃく	微弱
ひしゃく	柄杓
ひしゃ	飛車
びしつ	美質
ひしがた	菱形
びし	微視
ひじ	肘
ひじ	肱
ひし	菱
ひさん	飛散
ひさん	悲惨
ひさびさ	久々
ひさしぶり	久しぶり
ひざし	陽射し
ひざし	陽射
ひざし	日射し
ひざし	日射
ひざし	日差し
ひざし	日差
ひさし	庇
ひさし	久し
びさい	微細
ひさい	被災
ひざ	膝
ひさ	鬻
ひさ	久
ひごろ	日頃
ひごと	日毎
ひこく	被告
ひごかん	非互換
ひこうじょう	飛行場
ひこうき	飛行機
びこう	尾行
びこう	備考
ひこう	飛行
ひこう	非行
ひごい	緋鯉
ひご	籤
ひご	庇護
ひけんしゃ	被験者
ひけん	比肩
ひけつ	秘訣
ひけつ	否決
ひげき	悲劇
ひげ	鬚
ひげ	髭
ひげ	卑下
ひくめ	低め
ひくつ	卑屈
ひく	低
ひきんぞく	卑金属
ひきんしつ	非均質
ひきん	卑近
ひきわたし	引渡し
ひきわた	引き渡
ひきわけ	引き分け
ひきょり	飛距離
ひきよせ	引き寄せ
ひぎょう	罷業
ひきょう	秘境
ひきょう	比況
ひきょう	卑怯
ひきゃく	飛脚
ひきもど	引き戻
ひきふね	曳舟
ひきはな	引き離
ひきのば	引き伸ば
ひきのば	引き延ば
ひきぬ	引き抜
ひきにく	挽肉
ひきとめ	引き留め
ひきとめ	引き止め
ひきと	引き取
ひきでもの	引出物
ひきつづき	引続き
ひきつづ	引き続
ひきつけ	引き付け
ひきつ	引き継
ひきたて	引立て
ひきだし	引出し
ひきだ	引き出
ひきた	引き立
ひきず	引きず
ひきしめ	引き締め
ひきしま	引き締ま
ひきしお	引き潮
ひきざん	引算
ひきざん	引き算
ひきさげ	引下げ
ひきさげ	引き下げ
ひきさが	引き下が
ひきさ	引き裂
ひきさ	引きさ
ひきこ	引き込
ひきがね	引金
ひきがえる	蟇蛙
ひきかえ	引換
ひきかえ	引き返
ひきかえ	引き替え
ひきおろ	引き下ろ
ひきおと	引き落と
ひきうつ	引き写
ひきうつ	引き移
ひきうけ	引受け
ひきうけ	引受
ひきうけ	引き受け
ひきい	率い
ひきあわせ	引き合わせ
ひきあて	引当
ひきあげ	引き揚げ
ひきあげ	引き上げ
ひきあい	引合い
ひきあい	引合
ひきあ	引き合
ひぎ	秘技
ひき	引き
びかん	美観
ひがん	悲願
ひがん	彼岸
ひかん	悲観
ひかり	光
ひからび	干からび
ひがた	干潟
ひがしぐち	東口
ひがしがわ	東側
ひがし	東
ひかげ	日陰
びがく	美学
ひかく	皮革
ひかく	比較
ひがえり	日帰り
ひかえしつ	控室
ひかえ	控え
ひがいしゃ	被害者
ひがい	被害
びか	美化
ひが	僻
ひか	皮下
ひか	光
びえん	鼻炎
ひえこ	冷え込
ひえ	冷え
ひえ	稗
ひうん	非運
ひいろ	緋色
ひいらぎ	柊
ひいまご	曾孫
ひいで	秀で
ひいき	贔屓
ひあい	悲哀
び	美
び	日
ひ	陽
ひ	非
ひ	秘
ひ	碑
ひ	比
ひ	妃
ひ	日
ひ	灯
ひ	弾
ひ	退
ひ	惹
ひ	牽
ひ	干
ひ	火
ひ	曳
ひ	引
はんろん	反論
はんろ	坂路
はんれい	凡例
はんれい	反例
はんれい	判例
はんりょう	半量
はんりょ	伴侶
はんらん	氾濫
はんらん	反乱
はんらく	反落
ばんらい	万雷
はんよう	汎用
ばんゆう	万有
はんもん	煩悶
はんもん	反問
はんもと	版元
はんもく	反目
はんも	繁茂
ばんめん	盤面
はんめん	反面
はんめん	半面
はんめい	判明
ばんみん	万民
はんみょう	斑猫
はんみ	半身
はんぼう	繁忙
はんべつ	判別
ばんぺい	番兵
はんぶん	半分
ばんぶつ	万物
はんぷく	反復
はんぷ	頒布
はんぴれい	反比例
はんはん	半々
はんぱつ	反発
ばんぱく	万博
はんばいき	販売機
はんばい	販売
はんぱ	半端
はんば	飯場
ばんのう	万能
はんのう	反応
ばんねん	晩年
はんね	半値
ばんにん	万人
ばんにん	番人
はんにん	犯人
はんにゅう	搬入
はんにゃとう	般若湯
はんにゃ	般若
はんにち	反日
はんにち	半日
はんとし	半年
はんどく	判読
はんとき	半時
はんとうめい	半透明
はんどうたい	半導体
ばんとう	番頭
はんどう	反動
はんとう	半島
はんと	版図
はんてん	斑点
はんてん	反転
はんてい	判定
はんつき	半月
はんちょう	班長
はんちゅう	範疇
ばんちゃ	番茶
ばんち	番地
はんだん	判断
はんだくおん	半濁音
ばんだい	番台
はんたい	反対
はんそで	半袖
はんそく	反則
ばんそう	伴奏
はんそう	搬送
はんそ	反訴
ばんぜん	万全
ばんせん	番線
はんぜん	判然
ばんせい	蛮声
ばんせい	晩成
はんせい	反省
はんすう	反芻
はんすう	半数
はんしんろん	汎神論
はんしんはんぎ	半信半疑
はんしん	半身
はんしょくち	繁殖地
はんしょく	繁殖
ばんじょう	万丈
ばんじょう	盤上
ばんしょう	万障
はんじょう	繁盛
はんしょう	半鐘
はんしょう	半焼
ばんしょ	板書
ばんしゅん	晩春
はんしゅつ	搬出
ばんじゅく	晩熟
はんじゅく	半熟
ばんしゅう	晩秋
はんしゅう	半周
ばんしゃく	晩酌
はんしゃ	反射
はんしはんしょう	半死半生
はんした	版下
ばんじ	万事
はんじ	判事
はんし	藩士
はんし	半紙
ばんさん	晩餐
はんさよう	反作用
はんざつ	煩雑
はんざつ	繁雑
ばんざい	万歳
はんざい	犯罪
はんさ	煩瑣
ばんこん	晩婚
ばんこっき	万国旗
ばんこく	万国
ばんごう	番号
はんこう	犯行
はんこう	反抗
はんご	反語
はんこ	判子
はんげん	半減
はんけん	版権
はんけん	半券
はんけつ	判決
はんげき	反撃
はんけい	半径
ばんぐみ	番組
ばんきん	板金
はんきょう	反響
はんきゅう	半球
はんぎゃく	反逆
はんき	半期
はんき	半旗
はんかんすう	汎関数
ばんかん	万感
はんかん	反感
はんかつう	半可通
はんがく	半額
はんかく	半角
はんかがい	繁華街
ばんがい	番外
ばんかい	挽回
はんかい	半壊
ばんか	晩夏
ばんか	挽歌
はんか	頒価
はんか	繁華
はんか	汎化
はんえん	半円
はんえい	繁栄
はんえい	反映
はんい	範囲
ばん	盤
ばん	番
ばん	晩
ばん	版
ばん	板
ばん	判
はん	範
はん	藩
はん	班
はん	版
はん	反
はん	半
はん	判
はろう	波浪
はれわた	晴れ渡
はれつ	破裂
はれすがた	晴れ姿
はれぎ	晴れ着
ばれいしょ	馬鈴薯
はれあが	晴れ上が
はれ	晴れ
はれ	晴
はれ	腫れ
はるやすみ	春休み
はるめ	春め
はるか	遥か
はる	春
はりつけ	張り付け
はりだ	張り出
はりこ	張子
はりこ	張り込
ばりき	馬力
はりき	張り切
はりがみ	貼紙
はりがみ	張り紙
はりがね	針金
はりあわせ	張り合わせ
はりあ	張合
はりあ	張り合
ばり	罵詈
はり	玻璃
はり	梁
はり	針
はらんばんじょう	波瀾万丈
はらん	波乱
はらわた	腸
はらぐろ	腹黒
はらいもどし	払い戻し
はらいもど	払い戻
はらいさげ	払い下げ
はらいこ	払い込
ばら	薔薇
はら	孕
はら	払
はら	腹
はら	晴ら
はら	原
はよう	早う
はやめ	速め
はやめ	早め
はやま	速ま
はやま	早ま
はやべん	早弁
はやぶさ	隼
はやばや	早々
はやとちり	早とちり
はやと	隼人
はやて	疾風
はやせ	早瀬
はやし	囃子
はやし	林
はやくち	早口
はやく	端役
はやがてん	早合点
はやおき	早起き
はやうま	早馬
はや	流行
はや	速
はや	早
はや	生や
はや	逸
はもん	破門
はもん	波紋
はもの	刃物
はも	鱧
ばめん	場面
はめん	波面
はめつ	破滅
はめこ	はめ込
はめ	填め
はめ	羽目
はみで	はみ出
はみがきこ	歯磨き粉
はみがき	歯磨き
はまや	破魔矢
はまぐり	蛤
はまき	葉巻
はま	浜
はへん	破片
はべらか	侍らか
はへい	派兵
はべ	侍
はぶり	羽振り
はぶらし	歯ブラシ
はぶ	省
はふ	葬
ばひつ	馬匹
はばひろ	幅広
はばつ	派閥
はばた	羽ばた
はばか	憚
ははおや	母親
ばば	馬場
ばば	婆
はば	幅
はば	阻
はば	巾
はは	母
はねかえ	跳ね返
はね	跳ね
はね	羽根
はね	羽
ばぬし	馬主
はにわ	埴輪
はに	埴
はなれ	離れ
はなれ	放れ
はなやか	華やか
はなや	華や
はなや	花屋
はなむこ	花婿
はなみち	花道
はなみずき	花水木
はなみず	鼻水
はなみ	花見
はなふだ	花札
はなびら	花びら
はなびえ	花冷え
はなび	花火
はなばなし	華々し
はなはだし	甚だし
はなはだ	甚だ
はなどけい	花時計
はなぢ	鼻血
はなたば	花束
はなたかだか	鼻高々
はなぞの	花園
はなしこ	話し込
はなしか	噺家
はなしあい	話合い
はなしあ	話し合
ばなし	話
はなし	話
はなし	噺
はなさき	鼻先
はなざかり	花盛り
はなげ	鼻毛
はなくそ	鼻糞
はないた	花板
はな	話
はな	離
はな	放
はな	鼻
はな	華
はな	花
はどめ	歯止め
はとどけい	鳩時計
ばとう	罵倒
はどう	波動
はとう	波涛
はと	鳩
はてんこう	破天荒
はで	派手
はて	果て
はつろ	発露
はつれい	発令
はつゆき	初雪
はつもうで	初詣
はつめい	発明
はつみみ	初耳
ばっぽん	抜本
はっぽう	発砲
はっぽう	八方
ばつぶん	跋文
はっぷん	発奮
はっぷ	発布
はっぴょうしゃ	発表者
はっぴょうかい	発表会
はっぴょう	発表
はつびょう	発病
はつばい	発売
はっぱ	葉っぱ
はつねつ	発熱
はつに	初荷
はつどう	発動
はっと	法度
はつでんき	発電機
はつでん	発電
はってん	発展
ばってき	抜擢
はっちゅう	発注
はっちゃく	発着
ばっち	バッチ
はったつ	発達
ばっそく	罰則
はっそう	発送
はっそう	発想
はっせい	発声
はっせい	発生
ばっすい	抜粋
はっしんしゃ	発信者
はっしん	発進
はっしん	発疹
はっしん	発振
はっしん	発信
はつじょう	発情
はっしょう	発祥
はっしょう	八章
はっしゃ	発車
はっしゃ	発射
はっし	発止
はっさん	発散
はっこつ	白骨
はっこうしゃ	発行者
はっこう	醗酵
はっこう	発行
はっこう	発効
はつこい	初恋
ばっこ	跋扈
はつげん	発言
はつげん	発現
はっけん	発見
はっけん	発券
はっけっきゅう	白血球
ばつぐん	抜群
ばっくぷろぱげーしょんほう	バックプロパゲーション法
はっくつ	発掘
ばっきん	罰金
はっきん	白金
はっきょう	発狂
はっきゅう	発給
はっきゅう	薄給
はっきゅう	白球
はづき	葉月
はっき	発揮
はつがん	発ガン
はっかん	発刊
はっかく	発覚
はつが	発芽
はつか	二十日
はっか	発火
はっか	薄荷
はつおん	撥音
はつおん	発音
はつえんとう	発煙筒
はついく	発育
ばつ	跋
ばつ	閥
ばつ	罰
ばっ	罰
はつ	発
はつ	初
はっ	発
はちょう	波長
はちめんろっぴ	八面六臂
はちめんたい	八面体
はちみつ	蜂蜜
はちまん	八幡
はちまき	鉢巻き
はちまき	鉢巻
はちぶ	八分
はちく	破竹
ばちがい	場違い
はちうえ	鉢植え
ばち	罰
ばち	鉢
はち	蜂
はち	鉢
はだん	破談
はたん	破綻
はたらきかけ	働きかけ
はたら	働
はだみ	肌身
はたはた	鰰
はたち	二十歳
はたして	果して
はだし	裸足
はだざわり	肌触り
はだざむ	肌寒
ばたけ	畑
はたけ	畠
はたけ	畑
はだぎ	肌着
はだか	裸
はたおり	機織り
はたえ	二十重
はだいろ	肌色
はたいろ	旗色
はだあい	肌合
はだ	膚
はだ	肌
はた	畠
はた	畑
はた	端
はた	機
はた	旗
はた	果た
はそん	破損
はせん	破線
はせん	波線
ばせい	罵声
はせい	派生
はぜ	鯊
はぜ	櫨
はぜ	黄櫨
はせ	馳せ
はずれ	外れ
ばすてい	バス停
はずかしめ	辱め
はずかし	恥ずかし
ばすえ	場末
はすう	端数
はすい	破水
はず	筈
はず	弾
はず	外
はす	蓮
はしわたし	橋渡し
はしりまわ	走り回
はしりぬけ	走り抜け
はしりだ	走り出
はしりこ	走り込
はしりがき	走り書き
はしら	柱
はじょう	波状
ばしょ	場所
はしゅつじょ	派出所
はしゅつ	派出
ばしゃ	馬車
はしゃ	覇者
はじめて	初めて
はじめ	初め
はじめ	始め
はじめ	一
はじま	始ま
はしづめ	橋詰
はしご	梯子
はじい	恥じ入
はじ	恥じ
はじ	恥
はじ	弾
はじ	端
はし	箸
はし	端
はし	走
はし	橋
はさん	破産
はさみこ	挟み込
はさみ	鋏
はざま	硲
はざま	狭間
はざま	間
はさま	挟ま
はざかいき	端境期
はさい	破砕
はさ	挟
はこぶね	方船
はこぶね	方舟
はこぶね	箱船
はこびだ	運び出
はこびこ	運び込
はごいた	羽子板
はこ	箱
はこ	函
はこ	運
ばけん	馬券
はけん	派遣
はけん	覇権
はげま	励ま
はげし	烈し
はげし	激し
ばけがく	化学
はけい	波形
ばけ	化け
はげ	励
はげ	剥げ
はげ	矧げ
はげ	禿げ
はげ	禿
はけ	捌け
はけ	刷毛
はくろん	博論
ばくろ	暴露
はくろ	白露
はぐるま	歯車
はくりょく	迫力
はくり	薄利
はくり	剥離
はくらんきょうき	博覧強記
はくらんかい	博覧会
はくらく	剥落
はくらく	伯楽
はくらい	舶来
ばくやく	爆薬
ばくまつ	幕末
はくまい	白米
はくぼく	白墨
はくぶつし	博物誌
はくぶつかん	博物館
はくぶつ	博物
ばくふ	瀑布
ばくふ	幕府
はくび	白眉
ばくはつ	爆発
はくばい	白梅
ばくは	爆破
はくねつ	白熱
はくどう	白銅
はくちょう	白鳥
はくちゅう	白昼
ばくち	博奕
ばくち	博打
はくち	白痴
ばくだん	爆弾
はくだつ	剥奪
はくだく	白濁
ばくだい	莫大
ばくぜん	漠然
はくせき	白皙
はくせい	剥製
ばくしん	驀進
はくじん	白人
はくしん	迫真
はくしょく	白色
ばくしょう	爆笑
はくじょう	薄情
はくじょう	白状
はくしょ	白書
ばくしゅく	爆縮
はくじゅ	白寿
はくしゅ	拍手
はくじゃく	薄弱
はくしゃく	伯爵
はくしゃ	薄謝
はくしゃ	拍車
はくじつ	白日
はくしき	博識
はくじ	白磁
はくし	白紙
はくし	博士
ばくさい	博才
はくさい	白菜
はくげきほう	迫撃砲
ばくげき	爆撃
はぐく	育
はくがく	博学
はくがい	迫害
はくい	白衣
はくあい	博愛
はくあ	白亜
ばく	縛
ばく	漠
はく	箔
はく	泊
はく	博
はぎれ	端切れ
はぎれ	歯切れ
はきょく	破局
はぎょう	覇業
はきゅう	波及
ばきゃく	馬脚
はきもの	履物
はきだ	吐き出
はぎしり	歯軋り
はぎ	萩
はぎ	矧
はき	破棄
はき	覇気
はがんいっしょう	破顔一笑
はがん	破顔
はかりごと	謀
はかり	秤
はから	計ら
はかまいり	墓参り
はかま	袴
ばかばかし	バカバカし
はかば	墓場
はがね	鋼
はかな	儚
はかど	捗
はかせ	博士
ばかず	場数
はがき	葉書
はかい	破戒
はかい	破壊
ばか	馬鹿
ばか	化か
はが	剥
はか	量
はか	謀
はか	墓
はか	破瓜
はか	測
はか	図
はか	諮
はか	計
はおり	羽織
はえ	蝿
はえ	這え
はえ	生え
はえ	栄え
はえ	映え
はいれつ	配列
はいれつ	排列
はいりょ	配慮
はいりほう	背理法
ばいりつ	倍率
はいりこ	入り込
ばいよう	培養
はいゆう	俳優
ばいやく	売約
はいやく	配役
はいめん	背面
ばいめい	売名
はいぼく	敗北
はいぶん	配分
はいぶつきしゃく	排仏毀釈
はいぶつきしゃく	廃仏棄釈
はいぶつ	廃物
はいふく	拝復
はいふ	配布
はいふ	配付
はいひん	廃品
はいび	配備
はいばん	廃盤
はいはん	背反
はいはん	排反
ばいばい	売買
はいのう	背嚢
はいにん	背任
はいとう	配当
はいでんばん	配電盤
ばいてん	売店
はいでん	配電
はいちょう	拝聴
はいち	配置
はいたつ	配達
ばいたい	媒体
はいたい	敗退
はいた	排他
はいぞく	配属
ばいぞう	倍増
はいそう	配送
はいそ	敗訴
ばいせん	焙煎
はいぜん	配膳
はいせん	配線
はいせん	敗戦
はいぜつ	廃絶
はいせき	排斥
ばいすう	倍数
はいすいのじん	背水の陣
はいすい	配水
はいすい	排水
はいず	這いず
ばいじん	煤塵
ばいしん	陪審
はいじん	廃人
はいじん	俳人
はいしん	背信
ばいしょく	陪食
はいしょく	配色
ばいしょう	賠償
はいじょ	排除
ばいしゅん	売春
ばいしゅん	買春
はいしゅつ	排出
ばいしゅう	買収
ばいしゃく	媒酌
はいしゃく	拝借
はいしゃ	配車
はいしゃ	敗者
はいしゃ	廃車
はいしゃ	歯医者
はいし	廃止
はいざら	灰皿
はいごれい	背後霊
はいごう	配合
はいごう	交配
はいこう	廃鉱
はいこう	廃校
はいご	背後
はいけん	拝見
はいけい	背景
はいけい	拝啓
はいぐうしゃ	配偶者
はいぐう	配遇
はいく	俳句
ばいきん	黴菌
はいきん	背筋
はいぎょう	廃業
はいきょ	廃虚
はいきゅう	配給
はいきゅう	廃休
ばいきゃく	売却
はいき	排気
はいき	廃棄
はいがん	肺癌
はいかん	配管
はいかん	拝観
はいかん	廃刊
ばいがく	倍額
ばいかい	媒介
はいかい	徘徊
はいかい	俳諧
ばいか	売価
ばいか	倍加
はいか	配架
はいか	配下
はいか	輩下
はいか	排架
はいえん	肺炎
はいえい	背泳
ばいう	梅雨
はいいん	配員
はいいん	敗因
はいいろ	灰色
はいい	配位
はいあん	廃案
ばい	倍
はい	配
はい	肺
はい	排
はい	拝
はい	廃
はい	入
はい	灰
ばあさん	婆さん
はあく	把握
ばあい	場合
ば	貼
ば	張
ば	場
は	履
は	葉
は	噴
は	剥
は	矧
は	這
は	派
は	吐
は	貼
は	張
は	掃
は	刃
は	歯
は	喰
のんき	暢気
のろわし	呪わし
のろし	狼煙
のろ	鈍
のろ	呪
のりもの	乗物
のりもの	乗り物
のりまわ	乗り回
のりば	乗場
のりば	乗り場
のりと	祝詞
のりづけ	糊付け
のりつけ	乗り付け
のりつ	乗り継
のりだ	乗り出
のりすて	乗り捨て
のりこえ	乗り越え
のりこ	乗り込
のりこ	乗り越
のりくみいん	乗組員
のりく	乗り組
のりき	乗り切
のりかか	乗り掛る
のりかか	乗り掛かる
のりかか	乗りかか
のりかえ	乗替え
のりかえ	乗替
のりかえ	乗換え
のりかえ	乗換
のりかえ	乗り替え
のりかえ	乗り換え
のりおり	乗り降り
のりおくれ	乗り遅れ
のりうつ	乗り移
のりいれ	乗り入れ
のりあげ	乗り上げ
のり	糊
のり	海苔
のら	野良
のやま	野山
のめりこ	のめり込
のみや	飲み屋
のみもの	飲物
のみほ	飲み干
のみかい	飲み会
のみ	蚤
のぼりつめ	上り詰め
のほうず	野放図
のぼ	登
のぼ	上
のぼ	昇
のべ	野辺
のべ	伸べ
のべ	述べ
のべ	延べ
のぶし	野武士
のびやか	伸びやか
のびのび	伸び伸び
のびなや	伸び悩
のび	伸び
のび	延び
のはら	野原
のばなし	野放し
のば	伸ば
のば	延ば
ののし	罵
のなか	野中
のどか	長閑
のど	喉
のど	咽
のてんぶろ	野天風呂
のてん	野天
のっと	則
のっと	乗っ取
のっけ	乗っけ
のっか	乗っか
のちのち	後々
のち	後
のたま	宣
のぞみ	望み
のぞまし	望まし
のぞきこ	のぞき込
のぞ	臨
のぞ	望
のぞ	覗
のぞ	除
のせ	乗せ
のせ	載せ
のじゅく	野宿
のこり	残り
のこらず	残らず
のこぎり	鋸
のこ	残
のけ	退け
のけ	除け
のきなみ	軒並
のきさき	軒先
のぎ	禾
のき	軒
のがれ	逃れ
のが	逃
のうりん	農林
のうりょく	能力
のうりょう	納涼
のうりつ	能率
のうり	脳裏
のうやく	農薬
のうめん	能面
のうむ	濃霧
のうみん	農民
のうみつ	濃密
のうまく	脳膜
のうべん	能弁
のうふ	農夫
のうふ	納付
のうひん	納品
のうはんき	農繁期
のうは	脳波
のうにゅう	納入
のうどう	能動
のうど	濃度
のうてんき	脳天気
のうてんき	能天気
のうち	農地
のうたん	濃淡
のうそん	農村
のうそっちゅう	脳卒中
のうぜい	納税
のうずい	脳髄
のうじょう	農場
のうしゅく	濃縮
のうしゃ	納車
のうし	脳死
のうさん	農産
のうさつ	悩殺
のうさぎょう	農作業
のうさぎ	野兎
のうこつ	納骨
のうこうそく	脳硬塞
のうこう	農耕
のうこう	濃厚
のうぐ	農具
のうきん	納金
のうぎょう	農業
のうきょう	農協
のうきぐ	農機具
のうき	納期
のうかんき	農閑期
のうかん	納棺
のうかすいたい	脳下垂体
のうがくぶ	農学部
のうがく	農学
のうがく	能楽
のうかい	納会
のうか	農家
のうえん	農園
のういっけつ	脳溢血
のう	脳
のう	能
の	野
の	呑
の	退
の	乗
の	載
の	飲
ねんれい	年齢
ねんりん	年輪
ねんりょう	燃料
ねんりき	念力
ねんり	年利
ねんらい	年来
ねんまつ	年末
ねんまく	粘膜
ねんぽう	年報
ねんぽう	年俸
ねんべつ	年別
ねんぶつ	念仏
ねんぴょう	年表
ねんぴ	燃費
ねんぱい	年配
ねんぱい	年輩
ねんねん	年々
ねんない	年内
ねんどまつ	年度末
ねんとう	念頭
ねんとう	年頭
ねんど	粘土
ねんど	年度
ねんてん	捻転
ねんちょう	年長
ねんちゃく	粘着
ねんだんせい	粘弾性
ねんだい	年代
ねんすう	年数
ねんしょう	燃焼
ねんしょう	年少
ねんしょう	年商
ねんしょ	念書
ねんしゅつ	捻出
ねんじゅう	年中
ねんしゅう	年収
ねんじ	年次
ねんし	撚糸
ねんし	年始
ねんさん	年産
ねんざ	捻挫
ねんごろ	懇ろ
ねんごう	年号
ねんこう	年功
ねんげつ	年月
ねんぐ	年貢
ねんきん	年金
ねんきゅう	年休
ねんき	年季
ねんき	年期
ねんき	年忌
ねんがん	念願
ねんかん	年間
ねんかん	年刊
ねんがっぴ	年月日
ねんがじょう	年賀状
ねんがく	年額
ねんが	年賀
ねんいり	念入り
ねん	念
ねん	年
ねりなお	練り直
ねりあわせ	練り合わせ
ねりあげ	練り上げ
ねり	練り
ねら	狙
ねもと	根本
ねむら	眠ら
ねむた	眠た
ねむけ	眠気
ねむ	眠
ねみみにみず	寝耳に水
ねまわし	根回し
ねまき	寝間着
ねぶみ	値踏み
ねふだ	値札
ねぶそく	寝不足
ねぶか	根深
ねびき	値引き
ねびえ	寝冷え
ねはん	涅槃
ねばりづよ	粘り強
ねはば	値幅
ねば	粘
ねどし	子年
ねどこ	寝床
ねつれつ	熱烈
ねつりょう	熱量
ねづよ	根強
ねつぼう	熱望
ねつべん	熱弁
ねっぷう	熱風
ねっぱ	熱波
ねっとう	熱湯
ねっと	ネット
ねっちゅう	熱中
ねったいうりん	熱帯雨林
ねったい	熱帯
ねつぞう	捏造
ねっせん	熱戦
ねっしん	熱心
ねっしょう	熱唱
ねっしゃびょう	熱射病
ねっこ	根っ子
ねっきょう	熱狂
ねっき	熱気
ねつえん	熱演
ねつい	熱意
ねづ	根付
ねつ	熱
ねつ	寝つ
ねっ	熱
ねちがえ	寝違え
ねだん	値段
ねたばこ	寝煙草
ねた	妬
ねずみこう	鼠講
ねずみ	鼠
ねすご	寝過ご
ねじれ	捩れ
ねじれ	捻れ
ねじ	捩
ねじ	螺
ねじ	捻
ねざめ	寝覚め
ねさげ	値下げ
ねさがり	値下がり
ねざ	根ざ
ねごと	寝言
ねこぜ	猫背
ねこじた	猫舌
ねごこち	寝心地
ねこ	猫
ねこ	寝込
ねぎら	労
ねぎ	葱
ねぎ	値切
ねがいさげ	願い下げ
ねがい	願
ねか	寝か
ねえさん	姉さん
ねえ	姉
ねうち	値打ち
ねいろ	音色
ねいしん	佞臣
ねいき	寝息
ねい	寝入
ねあげ	値上げ
ねあがり	値上がり
ね	練
ね	値
ね	寝
ね	根
ね	音
ぬれ	濡れ
ぬるまゆ	ぬるま湯
ぬる	温
ぬりつぶ	塗りつぶ
ぬりつけ	塗り付け
ぬり	塗
ぬら	濡ら
ぬまち	沼地
ぬまた	沼田
ぬま	沼
ぬのじ	布地
ぬのきれ	布切れ
ぬの	布
ぬすみだ	盗み出
ぬすみ	盗み
ぬすびと	盗人
ぬす	盗
ぬし	主
ぬけめ	抜目
ぬけだ	抜け出
ぬけ	抜け
ぬくも	温も
ぬぐ	拭
ぬく	温
ぬきんで	抜きん出
ぬきと	抜き取
ぬきだ	抜き出
ぬきさし	抜き差し
ぬき	貫
ぬか	抜か
ぬか	糠
ぬえ	鵺
ぬいもの	縫物
ぬいめ	縫目
ぬいつけ	縫いつけ
ぬいこ	縫い込
ぬ	縫
ぬ	抜
ぬ	塗
ぬ	脱
にんめん	任免
にんめい	任命
にんむ	任務
にんぽう	忍法
にんぷ	妊婦
にんぷ	人夫
にんぴ	認否
にんてい	認定
にんち	認知
にんち	任地
にんたい	忍耐
にんそく	人足
にんそう	人相
にんずう	人数
にんじん	人参
にんしん	妊娠
にんじょう	刃傷
にんじょう	人情
にんしょう	認証
にんしょう	人称
にんじゅう	忍従
にんじゃ	忍者
にんしき	認識
にんさんぷ	妊産婦
にんげんみ	人間味
にんげんせい	人間性
にんげん	人間
にんぎょう	人形
にんきょう	任侠
にんきょう	仁侠
にんき	任期
にんき	人気
にんかん	任官
にんか	認可
にんい	任意
にん	任
にん	人
にわとり	鶏
にわさき	庭先
にわき	庭木
にわかあめ	にわか雨
にわか	俄
にわ	庭
にりん	二輪
にりゅう	二流
にらみあわせ	にらみ合わせ
にら	睨
にら	韮
にょらい	如来
にょうぼう	女房
にょう	尿
にょい	如意
にゅうわ	柔和
にゅうりょく	入力
にゅうりょう	入寮
にゅうよく	入浴
にゅうようじ	乳幼児
にゅうよう	入用
にゅうもん	入門
にゅうぶ	入部
にゅうばい	入梅
にゅうねん	入念
にゅうとう	入党
にゅうでん	入電
にゅうてい	入廷
にゅうだん	入団
にゅうたい	入隊
にゅうせん	入選
にゅうせき	入籍
にゅうせいひん	乳製品
にゅうじょう	入場
にゅうしょう	入賞
にゅうしょ	入所
にゅうしゅ	入手
にゅうしゃ	入社
にゅうしつ	入室
にゅうじ	乳児
にゅうし	入試
にゅうし	乳歯
にゅうさん	乳酸
にゅうさつ	入札
にゅうこん	入魂
にゅうこく	入国
にゅうこう	入港
にゅうこう	入構
にゅうこ	入庫
にゅうきん	入金
にゅうぎょう	乳業
にゅうきょう	入鋏
にゅうきょ	入居
にゅうがくしき	入学式
にゅうがくきん	入学金
にゅうがく	入学
にゅうかく	入閣
にゅうかいきん	入会金
にゅうかい	入会
にゅうか	入荷
にゅうか	乳化
にゅうえん	入園
にゅうえき	乳液
にゅういん	入院
にや	煮や
にもの	煮物
にもつ	荷物
にまめ	煮豆
にまいじた	二枚舌
にまいごし	二枚腰
にほんばれ	日本晴れ
にほんとう	日本刀
にほんじん	日本人
にほんしゅ	日本酒
にほんごか	日本語化
にほんいち	日本一
にほん	二本
にぼし	煮干
にぶん	二分
にふだ	荷札
にぶ	鈍
にびいろ	鈍色
にのく	二の句
にのうで	二の腕
にぬし	荷主
ににんしょう	二人称
にな	担
にどでま	二度手間
にど	二度
につま	煮詰ま
にっぽう	日報
にっとう	日当
にってい	日程
にっちょく	日直
にっちゅう	日中
にっすう	日数
にっしんげっぽ	日進月歩
にっしょく	日食
にっしょう	日照
にっしゃ	日射
にっし	日誌
にっさん	日産
にっさん	日参
にっころが	煮っころが
にっこう	日光
にっけい	日計
にっけい	日系
につけ	煮つけ
にづくり	荷造り
にづくり	荷作り
にっきん	日勤
にっきゅう	日給
にっき	日記
にっかん	日韓
にっかん	日刊
につかわし	似つかわし
にっか	日課
につ	似つ
にちようひん	日用品
にちようび	日曜日
にちよう	日曜
にちや	日夜
にちぼつ	日没
にちぶ	日舞
にちどく	日独
にちじょう	日常
にちじ	日次
にちじ	日時
にちげん	日限
にち	日
にたて	煮立て
にそくさんもん	二束三文
にせもの	偽物
にせい	二世
にせ	似せ
にせ	偽
にせ	贋
にしん	鰊
にしん	二審
にじょう	二乗
にじゅう	廿
にじゅう	二重
にじゅう	二十
にしゃたくいつ	二者択一
にしめ	煮しめ
にしび	西陽
にしび	西日
にしぐち	西口
にしきごい	錦鯉
にしき	錦
にしがわ	西側
にしかぜ	西風
にしかいがん	西海岸
にじ	滲
にじ	虹
にじ	二次
にし	螺
にし	西
にさんかたんそ	二酸化炭素
にころが	煮ころが
にごら	濁ら
にご	濁
にこ	煮込
にげん	二元
にげみち	逃げ道
にげだ	逃げ出
にげこ	逃げ込
にげ	逃げ
にぐるま	荷車
にくらし	憎らし
にくはく	肉薄
にくづき	肉付き
にくたい	肉体
にくせい	肉声
にくしん	肉親
にくしょく	肉食
にくしみ	憎しみ
にくぎゅう	肉牛
にくきゅう	肉球
にくがん	肉眼
にくかい	肉塊
にく	肉
にく	難
にく	憎
にぎわ	賑わ
にぎりつぶ	握りつぶ
にぎやか	賑やか
にぎ	握
にがわらい	苦笑い
にかわ	膠
にかよ	似通
にがにがし	苦々し
にがて	苦手
にがおえ	似顔絵
にかい	二階
にが	逃が
にが	逃
にが	苦
におわ	匂わ
におやか	匂やか
におう	仁王
にお	匂
にお	臭
にえ	煮え
にうけ	荷受け
にいづま	新妻
にいさん	兄さん
にあげ	荷揚げ
にあ	似合
に	弐
に	二
に	煮
に	似
に	荷
なんら	何等
なんら	何ら
なんもん	難問
なんみん	難民
なんぼく	南北
なんぽう	南方
なんぷん	何分
なんぶ	南部
なんぴょうよう	南氷洋
なんびょう	難病
なんびょう	何秒
なんぴと	何人
なんばん	南蛮
なんぱ	難破
なんぱ	軟派
なんねん	何年
なんにん	何人
なんにょ	男女
なんにち	何日
なんなく	難なく
なんとか	何とか
なんとう	南東
なんど	納戸
なんど	何度
なんてん	難点
なんでもかんでも	何でもかんでも
なんてつ	軟鉄
なんちょう	難聴
なんちゃくりく	軟着陸
なんたん	南端
なんだい	難題
なんだい	何台
なんぞや	何ぞや
なんぞ	何ぞ
なんせい	軟性
なんせい	南西
なんせ	何せ
なんすい	軟水
なんしょく	難色
なんしょ	難所
なんじゅう	難渋
なんじゃく	軟弱
なんしつ	軟質
なんしき	軟式
なんじ	汝
なんじ	難事
なんじ	爾
なんじ	何時
なんこつ	軟骨
なんごく	南国
なんこうふらく	難攻不落
なんこう	難航
なんこう	軟膏
なんぐん	南軍
なんきん	軟禁
なんきょく	難局
なんぎょう	難行
なんぎ	難儀
なんかん	難関
なんかい	難解
なんかい	南海
なんかい	何回
なんか	軟化
なんか	南下
なんい	難易
なんい	南緯
なん	難
なん	何
なわばり	縄張り
なわばり	縄張
なわて	畷
なわ	縄
なれずし	熟鮨
なれ	狎れ
なれ	馴れ
なれ	熟れ
なれ	慣れ
なりわい	生業
なりゆき	成行き
なりゆ	成り行
なりひび	鳴り響
なりたち	成立ち
なりた	成り立
なりきん	成金
ならわ	習わ
ならわ	慣わ
ならべ	並べ
ならびた	並び立
ならいごと	習い事
なら	列
なら	鳴ら
なら	並
なら	楢
なら	習
なら	均
なら	慣ら
なやまし	悩まし
なやま	悩ま
なや	悩
なめらか	滑らか
なめ	鞣
なめ	嘗め
なむ	南無
なみま	波間
なみはずれ	並外れ
なみなみ	並々
なみだぐまし	涙ぐまし
なみだぐ	涙ぐ
なみだ	涙
なみだ	波立
なみせん	波線
なみき	並木
なみかぜ	波風
なみあし	並足
なみ	浪
なみ	並
なみ	波
なまろく	生録
なまり	鉛
なまみ	生身
なまびょうほう	生兵法
なまなまし	生々し
なまず	鯰
なます	膾
なまけ	怠け
なまくび	生首
なまぐさ	生臭
なまえ	名前
なまいき	生意気
なま	鈍
なま	生
なへん	那辺
なべもの	鍋物
なべぞこ	鍋底
なべ	鍋
なふだ	名札
なぶ	嫐
なぶ	嬲
なのか	七日
なのか	7日
なのか	７日
なの	名乗
なにゆえに	何故に
なにゆえ	何故
なにもの	何者
なにぶん	何分
なにとぞ	何卒
なにせ	何せ
なにしろ	何しろ
なにごと	何事
なにげな	何気な
なにがし	某
なに	何
ななめ	斜め
ななつ	七つ
ななそじ	七十路
なな	七
なとり	名取
なで	撫で
なつやま	夏山
なつやすみ	夏休み
なつもの	夏物
なつめ	棗
なつむき	夏向き
なつふく	夏服
なっぱ	菜っ葉
なつば	夏場
なっとく	納得
なっとう	納豆
なづけ	名付け
なつかしの	懐かしの
なつかし	懐かし
なついん	捺印
なつ	夏
なだれ	雪崩
なだめ	宥め
なだか	名高
なだ	灘
なぞらえ	準え
なぞ	謎
なぜか	何故か
なぜ	何故
なすりつけ	擦り付け
なす	擦
なしとげ	成し遂げ
なじ	馴染
なじ	詰
なし	梨
なし	無し
なさそう	無さそう
なざし	名指し
なさけぶか	情け深
なさけな	情な
なさけな	情けな
なさけ	情け
なごりおし	名残惜し
なごり	名残
なごやか	和やか
なこうど	仲人
なご	和
なげやり	投げやり
なげつけ	投げつけ
なげだ	投げ出
なげこ	投げ込
なげかわし	嘆かわし
なげかけ	投げかけ
なげいれ	投げ入れ
なげ	投げ
なげ	嘆
なくな	無くな
なくな	亡くな
なぐさめ	慰め
なぐさ	慰
なぐ	殴
なく	無く
なく	亡く
なぎさ	渚
なぎ	薙
なぎ	凪
なき	亡き
ながれだ	流れ出
ながれこ	流れ込
ながれ	流れ
ながらく	長らく
なかよし	仲良し
なかよ	仲良
なかゆび	中指
ながや	長屋
ながもち	長持ち
ながめ	眺め
なかみ	中身
なかま	仲間
なかま	中間
なかほど	中程
ながび	長引
ながばり	長針
ながばなし	長話
なかば	半ば
ながの	永の
ながねん	長年
ながねん	永年
なかね	中値
なかにわ	中庭
なかにも	中にも
なかには	中には
ながなが	長々
なかなおり	仲直り
ながつづき	長続き
ながったらし	長ったらし
ながつき	長月
なかつぎ	中継ぎ
ながちょうば	長丁場
なかだるみ	中だるみ
ながたらし	長たらし
なかだち	媒
なかだち	仲立ち
なかたがい	仲たがい
ながそで	長袖
なかすじ	中筋
ながすぎ	長過ぎ
ながしこ	流し込
なかし	仲仕
なかごろ	中ごろ
ながぐつ	長靴
なかがい	仲買
ながうた	長唄
ながいき	長生き
ながい	長居
なかい	仲居
ながあめ	長雨
なが	流
なが	長
なが	永
なか	仲
なか	中
なお	猶
なお	直
なお	尚
なお	治
なえ	苗
なえ	萎え
ないりょく	内力
ないりく	内陸
ないらん	内乱
ないよう	内容
ないゆう	内憂
ないやく	内約
ないめん	内面
ないみつ	内密
ないほう	内包
ないふん	内紛
ないぶ	内部
ないはつ	内発
ないねん	内燃
ないてき	内的
ないてい	内定
ないち	内地
ないだく	内諾
ないぞう	内蔵
ないぞう	内臓
ないそう	内装
ないそう	内挿
ないそう	内層
ないせん	内線
ないせん	内戦
ないせつ	内接
ないせき	内積
ないせい	内声
ないせい	内政
ないせい	内省
ないしんのう	内親王
ないしん	内診
ないしん	内申
ないしん	内心
ないしょく	内職
ないじょう	内情
ないしょ	内緒
ないしゅっけつ	内出血
ないじゅ	内需
ないじつ	内実
ないしきょう	内視鏡
ないじ	内示
ないし	乃至
ないざい	内在
ないこく	内国
ないこう	内向
ないきん	内勤
ないきょく	内局
ないがしろ	蔑ろ
ないかく	内閣
ないかく	内角
ないがい	内外
ないかい	内科医
ないか	内科
ない	内
な	啼
な	鳴
な	名
な	無
な	薙
な	凪
な	成
な	菜
な	泣
な	為
どんらん	貪婪
どんよく	貪欲
どんよく	どん欲
どんま	鈍磨
とんぼがえり	蜻蛉返り
とんぼがえり	とんぼ返り
とんぼ	蜻蛉
どんぶり	丼
とんび	鳶
とんでんへい	屯田兵
どんてん	曇天
どんつう	鈍痛
とんちんかん	頓珍漢
どんちょう	緞帳
とんちゃく	頓着
どんじゅう	鈍重
どんこう	鈍行
どんかん	鈍感
とんかつ	豚カツ
どんか	鈍化
どん	鈍
とろろあおい	黄蜀葵
とろりーせん	トロリー線
どろぬま	泥沼
どろなわ	泥縄
どろどろ	泥々
どろじあい	泥試合
とろう	徒労
どろ	泥
とろ	瀞
とろ	吐露
どれい	奴隷
どれい	土鈴
とりよせ	取り寄せ
どりょく	努力
どりょうこう	度量衡
どりょう	度量
とりょう	塗料
とりやめ	取り止め
とりもの	捕物
とりもど	取り戻
とりも	取り持
とりめ	鳥目
とりみだ	取り乱
とりまとめ	取りまとめ
とりまぜ	取り混ぜ
とりま	取り巻
とりぷる	トリプル
とりひきさき	取引先
とりひき	取引
とりひき	取り引き
とりはら	取り払
とりはだ	鳥肌
とりはず	取り外
とりはから	取り計ら
とりのぞ	取り除
とりのこ	取り残
とりな	執り成
とりとめ	取り留め
とりどし	酉年
とりで	砦
とりつけ	取付
とりつけ	取り付け
とりつくろ	取り繕
とりつ	都立
とりつ	取り付
とりつ	取り次
とりちがえ	取り違え
とりたて	取立
とりたて	取り立て
とりだ	取り出
とりそろえ	取り揃え
とりそろ	取り揃
とりしらべ	取調
とりしらべ	取り調べ
とりしまりやく	取締役
とりしまり	取締り
とりしま	取り締ま
とりしき	取り仕切
とりさげ	取り下げ
とりさ	取り去
とりこわ	取り壊
とりこ	虜
とりこ	取り込
とりけし	取消
とりけ	取り消
とりくず	取り崩
とりく	取り組
とりきめ	取り決め
とりかわ	取り交わ
とりかこ	取り囲
とりかか	取り掛か
とりかえ	取り返
とりかえ	取り替え
とりかえ	取り換え
とりがー	トリガー
とりおと	取り落と
とりおこな	執り行
とりえ	取り柄
とりいれ	取入れ
とりいれ	取り入れ
とりいれ	採り入れ
とりいそぎ	取り急ぎ
とりい	鳥居
とりあつめ	取り集め
とりあつかい	取扱
とりあつか	取り扱
とりあげ	取り上げ
とりあげ	とり上げ
とりあえず	取り敢えず
とりあ	取り合
とり	酉
とり	鳥
とらわれ	捕らわれ
とらわれ	因われ
とらどし	寅年
とらえ	捕らえ
とらえ	捕え
とらえ	捉え
とらい	渡来
とら	寅
とら	虎
どようび	土曜日
どよう	土用
どよう	土曜
とよ	豊
ともびき	友引
ともばたらき	共働き
ともな	伴
ともども	共々
ともだち	友達
ともしび	灯火
ともえ	巴
ども	吃
とも	友
とも	灯
とも	共
とも	供
とめそで	留袖
とめ	留め
とめ	泊め
とめ	停め
とめ	止め
とむら	弔
とみん	都民
とみ	富
とまりこ	泊り込
とまり	泊り
とまど	戸惑
どま	土間
とま	留ま
とま	泊ま
とま	止ま
とぼし	乏し
どぼく	土木
とほう	途方
とほ	徒歩
どべい	土塀
とべい	渡米
とぶくろ	戸袋
どびん	土瓶
とびら	扉
どひょう	土俵
とびまわ	飛び回
とびはね	飛び跳ね
とびの	飛び乗
とびつ	飛びつ
とびち	飛び地
とびち	飛び散
とびだ	飛び出
とびこえ	飛び越え
とびこ	飛び込
とびこ	飛び越
とびか	飛び交
とびおり	飛び降り
とび	鳶
とひ	都鄙
とばり	帳
どばと	土鳩
とばく	賭博
とはいえ	とは言え
とば	飛ば
どのよう	どの様
とのがた	殿方
との	殿
どにち	土日
となりあわせ	隣合わせ
となりあ	隣り合
となり	隣
どなべ	土鍋
となえ	唱え
とない	都内
どな	怒鳴
とどろ	轟
とどめ	留め
とどめ	止め
とどまつ	椴
とどま	留ま
ととのえ	調え
ととのえ	整え
ととの	調
ととの	整
とどこお	滞
とどけで	届出
とどけ	届け
とどけ	届
とどうふけん	都道府県
どとう	怒涛
ととう	徒党
とど	届
とてい	徒弟
どて	土手
とつべん	訥弁
とっぷう	突風
とっぴょうし	突拍子
とっぱん	凸版
とっぱつ	突発
とっぱ	突破
とつにゅう	突入
とったん	突端
とつぜん	突然
とっしん	突進
とつじょとして	突如として
とつじょ	突如
とっしゅつ	突出
とっこうやく	特効薬
とっこう	特高
とっけん	特権
とつげき	突撃
とっくん	特訓
とっくり	徳利
とっくみあ	取っ組み合
どっきんほう	独禁法
とっきょ	特許
とっきゅう	特急
とっき	突起
とっかん	突貫
どっかい	読解
とっかい	特解
とっか	特価
とっか	特化
とつ	凸
とつ	嫁
とちょう	都庁
とちゅう	途中
とち	土地
どたんば	土壇場
とたん	途端
とたん	塗炭
とだな	戸棚
とだえ	途絶え
どだい	土台
どそく	土足
どぞう	土蔵
どそう	土葬
とそう	塗装
とそ	屠蘇
とぜつ	途絶
どすう	度数
としん	都心
としより	年寄り
としょかん	図書館
とじょうこく	途上国
どじょう	鰌
どじょう	鯲
どじょう	土壌
とじょう	途上
としょ	図書
としゅくうけん	徒手空拳
どしゃ	土砂
とじまり	戸締り
としま	年増
としなみ	年波
としつき	年月
としごろ	年頃
とじこめ	閉じ込め
としうえ	年上
としうえ	歳上
としあけ	年明け
とじ	閉じ
とじ	刀自
とじ	綴じ
とし	敏
とし	年
とし	都市
とし	歳
とざん	登山
とざま	外様
とさつ	屠殺
とざ	閉ざ
ところどころ	所々
ところ	所
ところ	処
とこや	床屋
とこばしら	床柱
とこなつ	常夏
どごう	怒号
どごう	土豪
とこう	渡航
どこ	何処
とこ	床
どけん	土建
とけつ	吐血
どけい	時計
とけい	時計
とげ	遂げ
とげ	刺
とけ	熔け
とけ	融け
とくれい	督励
とくれい	特例
どくりょく	独力
どくりつ	独立
とくよう	徳用
とくゆう	特有
どくやく	毒薬
とくやく	特約
とくめい	特命
とくめい	匿名
どくほん	読本
どくぼう	独房
とくべつ	特別
とくひつ	特筆
どくはく	独白
とくはいん	特派員
とくばい	特売
どくは	読破
とくは	特派
とくに	特に
どくどくし	毒々し
どくとく	独特
とくとう	特等
とくてん	特典
とくてん	得点
とくてい	特定
とくちょう	特長
とくちょう	特徴
とくちゅう	特注
とぐち	戸口
どくだんじょう	独壇場
どくだん	独断
とくだい	特大
とくそく	督促
どくそう	独走
どくそう	独奏
どくそう	独創
とくそう	特捜
どくそ	毒素
どくせんじょう	独擅場
どくせん	独占
とくせん	特選
とくせつ	特設
どくせい	毒性
とくせい	特製
とくせい	特性
どくしん	独身
とくしん	特進
とくしん	得心
とくしょく	特色
どくしょう	独唱
とくしょう	特賞
どくしょ	読書
とくしゅう	特集
とくじゅ	特需
とくしゅ	特殊
どくしゃ	読者
とくしってん	得失点
とくしつ	特質
とくしつ	得失
どくじ	独自
とくし	篤志
とくし	特使
とくさん	特産
とくさく	得策
どくさい	独裁
どくご	独語
とくぎ	特技
とくがわ	徳川
どくがく	独学
どくかい	読解
どくえん	独演
とくいげ	得意気
とくい	特異
とくい	得意
どく	毒
とく	督
とく	特
とく	徳
とく	得
とぎん	都銀
とぎれ	途切れ
ときょうそう	徒競走
どきょう	度胸
ときふせ	説き伏せ
どきどき	ドキドキ
ときどき	時々
ときおり	時折
ときおり	時おり
どき	土器
とぎ	砥
とき	鴇
とき	時
とがめ	咎め
どかた	土方
とかげ	蜥蜴
とかい	都会
とが	尖
とが	科
とか	溶か
とか	融か
とか	都下
とか	解か
とおりぬけ	通り抜け
とおりすぎ	通り過ぎ
とおり	通り
とおやま	遠山
とおまわり	遠回り
とおまわし	遠回し
とおまき	遠巻き
とおの	遠の
とおで	遠出
とおし	通し
とおざけ	遠ざけ
とおざか	遠ざか
とおく	遠く
とおか	十日
とおか	10日
とおか	１０日
とおあさ	遠浅
とお	通
とお	十
とお	遠
とえい	都営
とえ	十重
とうわく	当惑
どうわ	童話
どうわ	同和
とうろん	討論
とうろく	登録
とうろう	灯籠
とうろう	灯篭
どうろ	道路
どうれつ	同列
どうるい	同類
とうるい	盗塁
どうりょく	動力
どうりょう	同僚
とうりょう	頭領
とうりょう	等量
とうりょう	投了
とうりゅうもん	登竜門
とうりゅう	逗留
どうりつ	同率
とうりつ	倒立
どうり	道理
どうらん	胴乱
どうらん	動乱
どうらく	道楽
とうらく	当落
とうらい	到来
どうよう	童謡
どうよう	同様
どうよう	動揺
とうよう	当用
とうよう	登用
とうよ	投与
どうゆう	同友
とうゆ	灯油
とうやく	投薬
とうもろこし	玉蜀黍
どうもと	胴元
どうもく	瞠目
とうもく	頭目
どうもう	獰猛
とうめん	当面
どうめい	同盟
どうめい	同名
とうめい	透明
とうみん	島民
とうみん	冬眠
とうみょう	灯明
どうみゃくこうか	動脈硬化
どうみゃく	動脈
どうまごえ	胴間声
とうほんせいそう	東奔西走
とうほん	謄本
とうほく	東北
とうぼう	逃亡
とうほう	等方
とうほう	当方
とうほう	東方
とうへんぼく	唐変木
とうべん	答弁
とうへき	盗癖
とうぶん	糖分
とうぶん	等分
とうぶん	当分
どうぶつ	動物
どうふう	同封
どうふ	豆腐
とうぶ	頭部
とうぶ	当部
とうぶ	東部
とうふ	豆腐
どうひょう	道標
とうびょう	闘病
とうびょう	投錨
とうひょう	投票
とうひこう	逃避行
とうひ	逃避
とうひ	当否
どうはん	同伴
とうばん	当番
とうはん	登攀
とうばつ	討伐
とうはつ	頭髪
とうばく	倒幕
どうはい	同輩
どうは	道破
とうは	踏破
とうは	党派
どうねん	同年
とうねん	当年
とうにん	当人
どうにゅうご	導入後
どうにゅう	導入
とうにゅう	投入
とうなん	盗難
とうなん	東南
どうなが	胴長
どうない	道内
とうない	党内
とうどり	頭取
とうとつ	唐突
どうとく	道徳
どうどうめぐり	堂々巡り
どうどう	堂々
どうとう	同等
とうとう	滔々
とうと	尊
とうと	貴
どうでん	導電
どうてん	同点
どうてん	動転
とうでん	盗電
とうてん	読点
とうてん	当店
どうてき	動的
とうてき	投擲
どうてい	道程
どうてい	童貞
どうてい	同定
とうてい	到底
どうつう	導通
とうつう	疼痛
とうちょく	当直
とうちょうよう	頭頂葉
どうちょう	道庁
どうちょう	同調
とうちょう	盗聴
とうちょう	登頂
どうちゅう	道中
とうちゃん	父ちゃん
とうちゃく	到着
どうち	同地
どうち	同値
とうち	統治
とうち	当地
とうち	倒置
どうだん	同断
とうたつ	到達
どうたく	銅鐸
どうたい	胴体
どうたい	導体
とうだい	当代
とうだい	燈台
とうだい	灯台
とうた	淘汰
とうそつ	統率
とうぞく	盗賊
どうぞう	銅像
どうそう	同窓
どうそう	同相
とうそう	闘争
とうそう	逃走
とうそう	党争
どうぜん	同然
どうせん	導線
とうぜん	当然
とうせん	当選
どうせき	同席
とうせき	透析
とうせき	投石
どうせい	銅製
どうせい	同声
どうせい	同棲
どうせい	同性
どうせい	同姓
どうせい	動静
とうせい	陶製
とうせい	統制
とうせい	当世
どうすう	同数
とうすい	陶酔
とうしんだい	等身大
どうじんし	同人誌
どうしんえん	同心円
どうじん	同人
どうしん	童心
どうしん	同心
とうじん	蕩尽
とうしん	答申
とうしん	投身
どうしょくぶつ	動植物
どうしょく	同色
どうしょういむ	同床異夢
どうじょう	道場
どうじょう	同情
どうじょう	同乗
どうじょう	同上
どうしょう	銅賞
とうじょう	搭乗
とうじょう	登場
とうしょう	凍傷
どうじょ	童女
とうしょ	当初
とうしょ	投書
とうしょ	島嶼
とうしゅう	踏襲
どうしゅ	同種
とうしゅ	当主
とうしゅ	投手
とうしゅ	党首
とうしゃばん	謄写版
どうしゃく	同尺
どうしゃ	同社
とうしゃ	透写
とうしゃ	当社
とうしゃ	投射
どうじつ	同日
どうしつ	同質
どうしつ	同室
とうじつ	当日
とうしつ	等質
とうじしゃ	当事者
どうじく	同軸
とうじき	陶磁器
とうしき	等式
どうじ	童子
どうじ	同時
どうし	同氏
どうし	同志
どうし	同市
どうし	同士
どうし	動詞
とうじ	答辞
とうじ	当時
とうじ	湯治
とうじ	冬至
とうじ	杜氏
とうし	闘志
とうし	闘士
とうし	透視
とうし	投資
とうし	凍死
どうさん	動産
とうさん	父さん
とうさん	倒産
とうさま	父様
どうさつ	洞察
とうさつ	盗撮
とうさく	盗作
とうさく	倒錯
とうざい	東西
とうさい	搭載
どうさ	動作
とうざ	当座
どうこん	同梱
どうこん	同根
とうこん	闘魂
どうこく	慟哭
どうこく	同国
とうごく	投獄
どうこうほう	道交法
どうこうのし	同好の士
とうこうせん	等高線
とうごうしゃ	統合者
どうこう	瞳孔
どうこう	同行
どうこう	同好
どうこう	動向
とうごう	統合
とうごう	等号
とうこう	投降
とうこう	投稿
とうこう	登校
とうご	統語
とうげんきょう	桃源郷
どうけん	同県
とうけん	刀剣
どうげつ	同月
とうげつ	当月
とうけつ	凍結
どうけい	同系
どうけい	同形
どうけい	同型
とうげい	陶芸
とうけい	統計
とうけい	東経
どうけ	道化
とうげ	峠
とうぐん	東軍
どうくつ	洞窟
どうぐ	道具
どうきん	同衾
とうきょく	当局
どうぎょう	同業
どうきょう	同郷
どうきょ	同居
とうぎょ	統御
どうきゅう	撞球
どうきゅう	同級
とうぎゅう	闘牛
とうきゅう	等級
とうきゅう	投球
どうぎ	同義
どうぎ	動議
どうき	同期
どうき	動悸
どうき	動機
とうぎ	討議
とうき	騰貴
とうき	陶器
とうき	当機
とうき	当期
とうき	投機
とうき	投棄
とうき	冬季
とうき	冬期
とうき	登記
どうがん	童顔
どうかん	同感
とうがん	冬瓜
とうかん	等閑
とうかん	投函
とうがらし	唐辛子
どうかつ	恫喝
とうかつ	統括
どうがぞう	動画像
どうがく	同額
どうかく	同格
とうかく	頭角
とうかく	当確
とうかく	倒閣
とうがい	当該
とうかい	韜晦
とうかい	倒壊
どうが	童画
どうが	動画
どうか	銅貨
どうか	同化
とうか	透過
とうか	等価
とうか	灯火
とうか	投下
とうおんせん	等温線
どうおん	同音
とうえい	投影
どういん	動員
とういん	頭韻
とういん	党員
とういん	登院
どういつし	同一視
どういつ	同一
とういつ	統一
どうい	胴衣
どうい	同意
どうい	同位
とうい	糖衣
とうあん	答案
どう	銅
どう	胴
どう	同
どう	動
とう	糖
とう	等
とう	当
とう	灯
とう	棟
とう	投
とう	塔
とう	唐
とう	党
といただ	問い正
といただ	問い質
といし	砥石
といき	吐息
といかけ	問いかけ
といあわせ	問合せ
といあわせ	問い合わせ
とい	問
とい	樋
どあほ	ど阿呆
どあい	度合
ど	度
ど	°
と	溶
と	問
と	捕
と	富
と	飛
と	盗
と	都
と	賭
と	跳
と	説
と	摂
と	取
と	釈
と	撮
と	採
と	戸
と	研
と	解
でんわちょう	電話帳
でんわだい	電話代
でんわきょく	電話局
でんわ	電話
てんれつ	点列
でんれい	伝令
でんりょく	電力
でんりゅう	電流
てんり	天理
てんらん	展覧
てんらく	転落
でんらい	伝来
てんよう	転用
てんゆうしんじょ	天祐神助
てんもん	天文
てんめつ	点滅
てんまんぐう	天満宮
てんまつ	顛末
てんません	伝馬船
てんまく	天幕
でんぽう	電報
てんぼう	展望
てんぽ	店舗
てんぺんちい	天変地異
てんぺん	転変
でんぶん	電文
でんぶん	伝聞
てんぶん	天分
てんぷら	天麸羅
てんぶくろ	天袋
てんぷく	転覆
でんぶ	田麸
てんぷ	添付
てんびん	天秤
でんぴょう	伝票
てんびょう	点描
てんびき	天引き
てんぴ	天日
てんぴ	天火
でんぱん	伝搬
てんぱん	典範
てんばい	転売
でんぱ	電波
てんのうせい	天皇制
てんのう	天皇
てんねんとう	天然痘
てんねん	天然
でんねつ	電熱
でんねつ	伝熱
てんにん	転任
てんにょ	天女
てんにゅう	転入
てんない	店内
てんどん	天丼
てんどうせつ	天動説
でんどうき	電動機
でんどう	電動
でんどう	殿堂
でんどう	伝導
でんとう	電灯
でんとう	伝統
てんとう	点灯
てんとう	転倒
てんとう	店頭
でんてつ	電鉄
てんてき	点滴
てんてき	天敵
てんちょう	転調
てんちょう	店長
てんちょう	天頂
でんちゅう	電柱
でんちゅう	殿中
てんちゅう	天誅
でんち	電池
てんち	転置
てんち	転地
てんち	天地
てんたん	恬淡
でんたつ	伝達
でんたく	電卓
てんたい	天体
てんぞく	転属
てんそく	纏足
てんそく	天測
でんそう	電送
でんそう	伝送
てんそう	転送
でんせんびょう	伝染病
でんせん	電線
でんせん	伝染
てんせん	点線
でんせつ	伝説
てんせき	転籍
てんせき	転石
てんせい	転成
てんせい	展性
てんせい	天性
てんすう	点数
てんしんらんまん	天真爛漫
でんしん	電信
てんじん	天神
てんしん	点心
てんしん	転進
てんしん	転身
でんしょばと	伝書鳩
てんしょく	転職
てんしょく	天職
てんじょうてんげ	天上天下
てんじょううら	天井裏
でんしょう	伝承
てんじょう	添乗
てんじょう	天上
てんじょう	天井
てんしょう	転生
てんしょ	篆書
てんしょ	添書
てんしゅどう	天主堂
てんしゅつ	転出
でんじゅ	伝授
てんじゅ	天寿
てんしゅ	店主
でんしゃちん	電車賃
でんしゃ	電車
てんしゃ	転写
でんじは	電磁波
でんじき	電磁気
でんじ	電磁
でんし	電子
てんじ	点字
てんじ	展示
てんし	天使
でんさんき	電算機
てんさく	添削
てんざい	点在
てんさい	転載
てんさい	天災
てんさい	天才
でんごん	伝言
てんごく	天国
てんこう	転校
てんこう	転向
てんこう	天候
てんこ	点呼
でんげん	電源
てんけん	点検
でんげき	電撃
てんけい	典型
てんくぎ	天釘
てんくう	天空
てんぐ	天狗
てんきん	転勤
でんきょく	電極
てんぎょう	転業
てんきょ	転居
てんきょ	典拠
でんきゅう	電球
でんき	電気
でんき	電機
でんき	電器
てんき	転記
てんき	転機
てんき	天気
てんかん	転換
でんかい	電解
てんがい	天涯
てんかい	転回
てんかい	展開
でんか	電荷
でんか	電化
でんか	殿下
てんか	点火
てんか	転嫁
てんか	転化
てんか	添加
てんか	天下
てんえんせい	展延性
でんえん	田園
てんいん	店員
てんいむほう	天衣無縫
でんい	電位
てんい	転移
てんい	転位
でんあつ	電圧
てん	点
てん	転
てん	天
てわた	手渡
てわけ	手分け
てれんてくだ	手練手管
てれびきょく	テレビ局
てれくさ	照れ臭
てれ	照れ
てる	照
てる	輝
てりつけ	照りつけ
てりかえ	照り返
てら	衒
てら	照ら
てら	寺
てもと	手元
てもち	手持ち
でめきん	出目金
でむかえ	出迎え
てむか	手向か
でむ	出向
でみせ	出店
てみじか	手短
てまわし	手回し
でまわ	出回
てまり	手毬
てまど	手間取
てまえがって	手前勝手
てまえ	手前
てま	手間
てほん	手本
てほどき	手ほどき
てべんとう	手弁当
てふだ	手札
でぶしょう	出不精
てぶくろ	手袋
てびき	手引き
てびき	手引
てびかえ	手控え
でばん	出番
でばぼうちょう	出刃包丁
てばな	手放
てはじめ	手始め
でばがめ	出歯亀
てはい	手配
でば	出刃
てのひら	掌
てのひら	手の平
てぬぐい	手拭い
てぬぐい	手ぬぐい
てぬき	手抜き
てなおし	手直し
でなお	出直
てどり	手取り
でどころ	出所
でどころ	出どころ
てつり	哲理
てつや	徹夜
てづまり	手詰り
てづま	手詰ま
てっぽう	鉄砲
てつぼう	鉄棒
てっぺん	天辺
てっぺい	撤兵
てっぷ	轍鮒
てつびん	鉄瓶
てっぱん	鉄板
てっぱい	撤廃
でっぱ	出っ歯
でっぱ	出っぱ
てっとりばや	手っ取り早
てっとうてつび	徹頭徹尾
てつどう	鉄道
てっとう	鉄塔
てってい	徹底
てつづき	手続き
てつづき	手続
でっち	丁稚
てったい	撤退
てつだ	手伝
てっそく	鉄則
てっせん	鉄線
てっせん	鉄扇
てっせい	鉄製
てつじん	鉄人
てつじん	哲人
てつじょうもう	鉄条網
てっしょう	徹宵
てっしゅう	撤収
てつざい	鉄材
てっこつ	鉄骨
てつごうし	鉄格子
てっこう	鉄鋼
てっこう	鉄鉱
てっこう	鉄工
てつけきん	手付金
てづくり	手作り
でつく	出尽く
てっきん	鉄筋
てっきょう	鉄橋
てっきょ	撤去
てっき	鉄器
てっき	敵機
てっかん	鉄管
てっかば	鉄火場
てつがく	哲学
てっかい	撤回
てつ	鉄
てつ	徹
てっ	徹
てちょう	手帳
てちょう	手帖
てちがい	手違い
てぢか	手近
てだて	手立て
てだすけ	手助け
てだし	手出し
でそろ	出そろ
てぜま	手狭
てずから	手ずから
てすう	手数
てじょう	手錠
てじゅんしょ	手順書
てじゅん	手順
てじな	手品
てした	手下
てしごと	手仕事
でし	弟子
てざわり	手触り
てさげ	手提げ
てさげ	手提
でさき	出先
てさき	手先
てごわ	手強
てごわ	手ごわ
てごろ	手頃
てごろ	手ごろ
てごめ	手篭め
てごま	手駒
でこぼこ	凸凹
てごたえ	手応え
てこ	梃
てくび	手首
でぐち	出口
てぐち	手口
てくだ	手管
でく	木偶
てぎわ	手際
てきれいき	適齢期
てきれい	適齢
てきりょう	適量
てきよう	適用
てきよう	摘要
てきやく	適役
てきほう	適法
てきびし	手厳し
てきひ	適否
てきはつ	摘発
できばえ	出来栄え
てきにん	適任
てきとう	適当
てきど	適度
てきちゅう	的中
てきち	適地
てきち	敵地
できだか	出来高
てきたい	敵対
てきせつ	適切
てきせい	適正
てきせい	適性
てきじん	敵陣
てきじょ	滌除
てきしゅつりつ	摘出率
てきしゅつ	摘出
てきしゃ	適者
できし	溺死
てきじ	適時
てきし	敵視
てきざい	適材
できごと	出来事
てきごう	適合
てきぎ	適宜
てきかく	適格
てきかく	的確
てきがいしん	敵愾心
てきおう	適応
てきい	敵意
できあが	出来上が
できあい	溺愛
できあい	出来合い
でき	出来
てき	適
てき	的
てき	敵
てがる	手軽
てがら	手柄
てがみ	手紙
てがた	手堅
てがた	手形
でかせぎ	出稼ぎ
てかず	手数
てかげん	手加減
でかけ	出かけ
てがけ	手掛け
てがけ	手がけ
てがき	手書き
てがかり	手掛かり
てがかり	手がかり
ており	手織
ておち	手落ち
ておくれ	手遅れ
てうす	手薄
ていれい	定例
ていれ	手入れ
ていりょうてき	定量的
ていりょう	定量
ていりゅう	底流
ていりゅう	停留
ていりつ	低率
でいりぐち	出入口
でいり	出入り
ていり	定理
ていり	低利
ていらく	低落
ていめん	底面
ていめい	低迷
ていぼう	堤防
ていへん	底辺
ていひょう	定評
ていばん	定番
ていはく	碇泊
ていはく	停泊
ていのう	低能
ていねん	定年
でいねい	泥濘
ていねい	丁寧
ていどさ	程度差
ていとう	抵当
ていとう	低頭
ていど	程度
ていと	帝都
ていでん	停電
ていてん	定点
ていてつ	蹄鉄
ていっぱい	手一杯
ていちょう	低調
ていちょう	丁重
ていちゃく	定着
ていち	定置
ていち	低地
ていだん	鼎談
ていたく	邸宅
ていたい	停滞
ていぞく	低俗
ていそく	低速
ていそう	貞操
ていそ	提訴
ていせん	停戦
ていせつ	定説
ていせいてき	定性的
ていせい	訂正
ていせい	定性
ていすう	定数
ていすいじゅん	低水準
でいすい	泥酔
ていしん	逓信
ていしょく	抵触
ていしょく	定食
ていしょく	定職
ていじょう	定常
ていじょう	呈上
ていしょう	提唱
ていしゅつび	提出日
ていしゅつ	提出
ていしゅく	貞淑
ていしゅかんぱく	亭主関白
ていじゅう	定住
ていしゅ	亭主
ていしゃ	停車
ていしつ	低湿
ていじせい	定時制
ていしきか	定式化
ていじ	提示
ていじ	定時
ていじ	呈示
ていし	停止
ていさつ	偵察
ていざいは	定在波
ていさい	体裁
ていこく	帝国
ていこく	定刻
ていこう	抵抗
ていげん	提言
ていげん	低減
ていけん	定見
ていけつ	締結
ていけい	提携
ていけい	定型
ていくう	低空
ていきん	提琴
ていきょう	提供
ていきゅうび	定休日
ていきゅう	庭球
ていきゅう	定休
ていきゅう	低級
ていぎいき	定義域
ていきあつ	低気圧
ていぎ	定義
ていき	提起
ていき	定期
ていかん	定款
ていがくねん	低学年
ていがく	定額
ていがく	低額
ていかく	定格
ていか	定価
ていか	低価
ていか	低下
ていおん	低音
ていおん	低温
ていおう	帝王
ていえん	庭園
ていいん	定員
ていい	定位
ていあん	提案
ていあつ	低圧
てい	邸
てい	訂
てい	挺
てい	底
てい	呈
てい	丁
てい	体
である	出歩
てあらい	手洗い
てあら	手荒
てあて	手当
てあつ	手厚
であし	出足
てあし	手足
であ	出会
で	出
て	照
て	手
つんぼ	聾
つれもど	連れ戻
つれだ	連れ出
つれそ	連れ添
つれこ	連れ込
つれかえ	連れ帰
つれ	連れ
つるべ	釣瓶
つるっぱげ	つるっ禿
つるぎ	剣
つる	鶴
つる	吊
つる	弦
つりだ	釣り出
つりだ	吊り出
つりあげ	つり上げ
つりあが	つり上が
つりあい	釣合
つりあ	釣り合
つらね	連ね
つらぬきとお	貫き通
つらぬ	貫
つらな	連な
つらがまえ	面構え
つら	面
つら	辛
つよめ	強め
つよま	強ま
つよき	強気
つよ	強
つゆ	露
つゆ	梅雨
つや	通夜
つや	艶
つも	積も
つめた	冷た
つめしょうぎ	詰将棋
つめしょ	詰所
つめご	詰碁
つめこ	詰め込
つめかけ	詰めかけ
つめかえ	詰め替え
つめあわせ	詰合わせ
つめあわせ	詰合せ
つめあわせ	詰め合わせ
づめ	詰め
つめ	爪
つめ	詰め
つむぎ	紬
つむ	紡
つみほろぼし	罪滅ぼし
つみのこ	積み残
つみに	積荷
つみたて	積立て
つみたて	積み立て
つみだ	積み出
つみこ	積み込
つみき	積木
つみかさね	積み重ね
つみかさな	積み重な
つみかえ	積み替え
つみあげ	積み上げ
つみ	罪
つまみだ	つまみ出
つまづ	躓
つまさき	爪先
つま	摘
つま	妻
つま	詰ま
つぼすう	坪数
つぼ	壷
つぼ	坪
つぶれ	潰れ
つぶより	粒選り
つぶて	礫
つぶ	粒
つぶ	潰
つばめ	燕
つばさ	翼
つばき	椿
つば	鍔
つば	唾
つの	募
つの	角
つねづね	常々
つね	常
つね	恒
つなみ	津波
つなげ	繋げ
つなぎとめ	つなぎ止め
つなぎ	繋
つなが	繋が
つな	綱
つな	繋
つとめて	努めて
つとめさき	勤め先
つとめ	務め
つとめ	勉め
つとめ	努め
つとめ	勤め
つとま	勤ま
つど	都度
つど	集
つて	伝手
つて	伝
つづり	綴
つつみこ	包み込
つつみがみ	包み紙
つづみ	鼓
つつみ	包
つつみ	堤
つっぷ	つっ伏
つっぱし	つっ走
つっぱ	突っ張
つっつ	突っつ
つつしんで	謹んで
つつし	慎
つつし	謹
つっこ	突っ込
つっけんどん	突慳貪
つづけ	続け
つっかか	突っかか
つっかえ	突っ返
つつうらうら	津々浦々
つづ	綴
つづ	続
つつ	包
つつ	筒
つちふまず	土踏まず
つちのと	己
つちのえ	戊
つちくれ	土くれ
つちか	培
つちおと	槌音
つち	土
つち	鎚
つち	槌
つたわ	伝わ
つたな	拙
つたえ	伝え
つた	蔦
つじつま	辻褄
つじ	辻
つごう	都合
つけやきば	付焼刃
つけやきば	付け焼き刃
つけもの	漬物
つけねら	付け狙
つけた	付け足
つけこ	付け込
つけこ	漬け込
つけくわえ	付け加え
つげぐち	告げ口
つけかた	付け方
つけかえ	付け替え
つげ	柘植
つげ	告げ
つけ	付け
つけ	点け
つけ	漬け
つくろ	繕
つくりだ	創り出
つくりだ	作り出
つくりだ	つくり出
つくりかた	作り方
つくりあげ	造り上げ
つくりあげ	作り上げ
つくり	作り
つぐみ	鶫
つぐな	償
つくだに	佃煮
つくだ	佃
づくえ	机
つくえ	机
つく	造
つく	創
つく	尽く
つく	作
つきよ	月夜
つきやま	築山
つぎめ	継目
つきみ	月見
つきまと	付きまと
つきべつ	月別
つきひ	月日
つきばらい	月払い
つきはな	突き放
つきとめ	突き止め
つきつめ	突き詰め
つきつけ	突き付け
つぎつぎ	次々
つきづき	月々
つぎた	継ぎ足
つきだ	突き出
つきそい	付添い
つきそい	付添
つきそ	付き添
つきすす	突き進
つきさ	突き刺
つきぎり	月切り
つきぎり	月切
つきぎめ	月極め
つきがけ	月掛け
つきあわせ	突き合わせ
つきあげ	突き上げ
つきあ	付き合
つきあ	つき合
つぎ	次
つき	付き
つき	尽き
つき	月
つかれ	疲れ
つかみあ	つかみ合
つかまえ	捕まえ
つかま	捕ま
つかのま	束の間
つかさど	司
つかえ	仕え
つかいわけ	使い分け
つかいこな	使いこな
つかいこ	使い込
つかいがって	使い勝手
つがい	番
づか	塚
つか	漬か
つか	掴
つか	塚
つか	浸か
つか	使
つか	遣
つえ	杖
つうわ	通話
つうろ	通路
つうれつ	痛烈
つうれい	通例
つうよう	通用
つうやく	通訳
つうほう	通報
つうふう	通風
つうねん	通念
つうどく	通読
つうでん	通電
つうてん	痛点
つうちょう	通帳
つうち	通知
つうたつ	通達
つうぞく	通俗
つうそう	通奏
つうせつ	通説
つうせつ	痛切
つうしんもう	通信網
つうしん	通信
つうじょう	通常
つうしょう	通称
つうしょう	通商
つうじ	通時
つうし	通史
つうさんしょう	通産相
つうさん	通算
つうさん	通産
つうこん	痛恨
つうこく	通告
つうこく	痛哭
つうこうどめ	通行止
つうこう	通行
つうげき	痛撃
つうきん	通勤
つうき	通気
つうかん	通関
つうかん	通巻
つうかん	痛感
つうがく	通学
つうかく	痛覚
つうかい	痛快
つうか	通過
つうか	通貨
つうえん	通園
つういん	通院
つう	通
ついろく	追録
ついらく	墜落
ついや	費や
ついほう	追放
ついば	啄
ついにん	追認
ついに	遂に
ついとつ	追突
ついとう	追悼
ついちょう	追徴
ついたち	一日
ついたち	1日
ついたち	１日
ついそ	追訴
ついせき	追跡
ついずい	追随
ついしん	追伸
ついしょう	追従
ついじゅう	追従
ついしけん	追試験
ついし	追試
ついし	墜死
ついげき	追撃
ついきゅう	追究
ついきゅう	追求
ついきゅう	追及
ついき	追記
ついかんばん	椎間板
ついか	追加
ついおく	追憶
つい	対
づ	津
つ	附
つ	付
つ	突
つ	撞
つ	摘
つ	釣
つ	吊
つ	津
つ	注
つ	着
つ	接
つ	積
つ	衝
つ	就
つ	次
つ	嗣
つ	継
つ	詰
ちんれつ	陳列
ちんもく	沈黙
ちんみ	珍味
ちんぼつ	沈没
ちんぽこ	似指
ちんぷ	陳腐
ちんとう	枕頭
ちんでん	沈澱
ちんでん	沈殿
ちんつう	鎮痛
ちんちょう	珍重
ちんだん	珍談
ちんたい	賃貸
ちんたい	沈滞
ちんせい	鎮静
ちんじょう	陳情
ちんじゅつ	陳述
ちんじゅ	鎮守
ちんしゃく	賃借
ちんしゃ	陳謝
ちんじ	珍事
ちんさげ	賃下げ
ちんざ	鎮座
ちんこう	沈降
ちんぎん	賃金
ちんきゃく	珍客
ちんき	珍奇
ちんか	鎮火
ちんか	沈下
ちんあつ	鎮圧
ちんあげ	賃上げ
ちん	陳
ちん	珍
ちん	朕
ちわ	痴話
ちりょう	治療
ちりばめ	散りばめ
ちり	地理
ちり	塵
ちらば	散らば
ちらか	散らか
ちら	散ら
ちょめい	著明
ちょめい	著名
ちょとつもうしん	猪突猛進
ちょっこう	直行
ちょっこう	直交
ちょっけつ	直結
ちょっけい	直系
ちょっけい	直径
ちょっき	直帰
ちょっかん	直観
ちょっかん	直感
ちょっかつ	直轄
ちょっかく	直角
ちょっか	直下
ちょちく	貯蓄
ちょぞう	貯蔵
ちょすいち	貯水池
ちょしょ	著書
ちょじゅつ	著述
ちょしゃ	著者
ちょさく	著作
ちょこ	猪口
ちょくれつ	直列
ちょくりゅう	直流
ちょくりつ	直立
ちょくやく	直訳
ちょくめん	直面
ちょくめい	勅命
ちょくほうたい	直方体
ちょくはん	直販
ちょくばい	直売
ちょくとう	直答
ちょくつう	直通
ちょくぞく	直属
ちょくそう	直送
ちょくぜん	直前
ちょくせん	直線
ちょくせつ	直截
ちょくせつ	直接
ちょくしん	直進
ちょくじょうけいこう	直情径行
ちょくじょう	直情
ちょくしゃ	直射
ちょくし	直視
ちょくさい	直截
ちょくご	直後
ちょくご	勅語
ちょくげき	直撃
ちょくえい	直営
ちょきん	貯金
ちょうわ	調和
ちょうろう	嘲弄
ちょうろう	長老
ちょうれいぼかい	朝令暮改
ちょうれい	朝礼
ちょうりょく	聴力
ちょうりょく	潮力
ちょうりょく	張力
ちょうりょう	跳梁
ちょうりゅう	潮流
ちょうりつ	調律
ちょうりつ	町立
ちょうり	調理
ちょうらく	凋落
ちょうよう	徴用
ちょうやく	跳躍
ちょうもん	弔問
ちょうもく	鳥目
ちょうめん	帳面
ちょうめ	丁目
ちょうみん	町民
ちょうみりょう	調味料
ちょうみ	調味
ちょうほんにん	張本人
ちょうほうけい	長方形
ちょうほう	諜報
ちょうほう	重宝
ちょうぼ	帳簿
ちょうへん	長辺
ちょうへん	長編
ちょうへい	徴兵
ちょうぶん	長文
ちょうぶつ	長物
ちょうふく	重複
ちょうひょう	帳票
ちょうばつ	懲罰
ちょうはつ	挑発
ちょうはつ	徴発
ちょうば	帳場
ちょうは	長波
ちょうなん	長男
ちょうない	町内
ちょうどきゅう	超弩級
ちょうど	調度
ちょうど	丁度
ちょうでんどう	超電導
ちょうでん	弔電
ちょうてん	頂点
ちょうてい	調停
ちょうてい	朝廷
ちょうちょうはっし	打々発止
ちょうちょう	長調
ちょうちょう	蝶々
ちょうちょう	町長
ちょうちょう	喋々
ちょうちゃく	打擲
ちょうたん	長短
ちょうたつ	調達
ちょうたく	彫琢
ちょうだい	頂戴
ちょうだい	長大
ちょうそん	長孫
ちょうそん	町村
ちょうぞう	彫像
ちょうぜん	超然
ちょうせん	挑戦
ちょうせつ	調節
ちょうせいき	調整器
ちょうせい	調製
ちょうせい	調整
ちょうしんき	聴診器
ちょうじん	超人
ちょうしん	長針
ちょうしん	長身
ちょうじり	帳尻
ちょうしょく	朝食
ちょうじょう	頂上
ちょうじょう	重畳
ちょうしょう	嘲笑
ちょうしょう	長嘯
ちょうしょう	弔鐘
ちょうじょ	長女
ちょうしょ	長所
ちょうしょ	調書
ちょうしゅう	聴衆
ちょうしゅう	徴収
ちょうじゅ	長寿
ちょうしゅ	聴取
ちょうじゃ	長者
ちょうしゃ	庁舎
ちょうじかん	長時間
ちょうじ	弔辞
ちょうし	長子
ちょうし	銚子
ちょうし	調子
ちょうさん	逃散
ちょうさ	調査
ちょうこくとう	彫刻刀
ちょうこく	超克
ちょうこく	彫刻
ちょうこうそく	超高速
ちょうこうぜつ	長広舌
ちょうごう	調合
ちょうごう	調号
ちょうこう	長考
ちょうこう	調香
ちょうこう	聴講
ちょうこう	兆候
ちょうげん	調弦
ちょうけし	帳消し
ちょうけい	長径
ちょうきん	超勤
ちょうきん	彫金
ちょうきょり	長距離
ちょうきょうし	調教師
ちょうきょう	調教
ちょうき	長期
ちょうき	弔旗
ちょうかん	鳥瞰
ちょうかん	長官
ちょうかん	朝刊
ちょうかく	聴覚
ちょうかいりょく	聴解力
ちょうかい	聴解
ちょうかい	町会
ちょうかい	朝会
ちょうかい	懲戒
ちょうか	超過
ちょうおんぱ	超音波
ちょうおん	長音
ちょうおん	聴音
ちょうえつ	超越
ちょうえき	懲役
ちょうえい	町営
ちょういん	調印
ちょうい	弔慰
ちょうい	弔意
ちょうあい	寵愛
ちょう	長
ちょう	蝶
ちょう	腸
ちょう	町
ちょう	朝
ちょう	徴
ちょう	弔
ちょう	庁
ちょう	帳
ちょう	寵
ちょう	喋
ちょう	兆
ちよ	千代
ちょ	著
ちゅうわ	中和
ちゅうりょく	注力
ちゅうりゅう	中流
ちゅうりゃく	中略
ちゅうりつ	中立
ちゅうよう	中庸
ちゅうや	昼夜
ちゅうもん	注文
ちゅうもん	中門
ちゅうもく	注目
ちゅうぼう	厨房
ちゅうぶん	中文
ちゅうふく	中腹
ちゅうぶう	中風
ちゅうぶ	中部
ちゅうばん	中盤
ちゅうばつ	誅伐
ちゅうのう	中濃
ちゅうねん	中年
ちゅうにゅう	注入
ちゅうにち	駐日
ちゅうなごん	中納言
ちゅうどく	中毒
ちゅうとう	中等
ちゅうと	中途
ちゅうてん	中点
ちゅうてん	中天
ちゅうてつ	鋳鉄
ちゅうっぱら	中っ腹
ちゅうちょ	躊躇
ちゅうだん	中断
ちゅうたい	中隊
ちゅうたい	中退
ちゅうそつ	中卒
ちゅうそく	中速
ちゅうぞう	鋳造
ちゅうせん	抽選
ちゅうぜつ	中絶
ちゅうせいし	中性子
ちゅうせい	忠誠
ちゅうせい	中性
ちゅうせい	中世
ちゅうすう	中枢
ちゅうすい	虫垂
ちゅうすい	注水
ちゅうしん	衷心
ちゅうしん	忠臣
ちゅうしん	中震
ちゅうしん	中心
ちゅうしょく	昼食
ちゅうじょう	中将
ちゅうしょう	抽象
ちゅうしょう	中小
ちゅうしょう	中傷
ちゅうじゅん	中旬
ちゅうしゅつ	抽出
ちゅうしゅう	仲秋
ちゅうしゃじょう	駐車場
ちゅうしゃく	注釈
ちゅうしゃ	駐車
ちゅうしゃ	注射
ちゅうじつ	忠実
ちゅうじ	中耳
ちゅうし	注視
ちゅうし	中止
ちゅうざい	駐在
ちゅうさい	仲裁
ちゅうざ	中座
ちゅうさ	中佐
ちゅうごし	中腰
ちゅうこく	忠告
ちゅうこうねん	中高年
ちゅうこうせい	中高生
ちゅうこ	中古
ちゅうげん	中元
ちゅうけん	中研
ちゅうけん	中堅
ちゅうけい	中継
ちゅうくう	中空
ちゅうきん	忠勤
ちゅうきょり	中距離
ちゅうきゅう	中級
ちゅうきぼ	中規模
ちゅうぎ	忠義
ちゅうき	注記
ちゅうき	抽気
ちゅうき	中期
ちゅうかんし	中間子
ちゅうかん	中間
ちゅうから	中辛
ちゅうがっこう	中学校
ちゅうがた	中型
ちゅうがくせい	中学生
ちゅうがく	中学
ちゅうかく	中核
ちゅうがえり	宙返り
ちゅうがい	虫害
ちゅうかい	注解
ちゅうかい	仲介
ちゅうか	中華
ちゅうおう	中央
ちゅういほう	注意報
ちゅういぶか	注意深
ちゅうい	注意
ちゅう	注
ちゅう	忠
ちゅう	宙
ちゅう	中
ちゅう	沖
ちゆ	治癒
ちゃわん	茶碗
ちゃや	茶屋
ちゃばん	茶番
ちゃのま	茶の間
ちゃっこう	着工
ちゃっかん	着艦
ちゃっか	着火
ちゃせん	茶筅
ちゃしゃく	茶杓
ちゃくりゅう	嫡流
ちゃくりく	着陸
ちゃくよう	着用
ちゃくもく	着目
ちゃくふく	着服
ちゃくばらい	着払
ちゃくにん	着任
ちゃくちゃく	着々
ちゃくち	着地
ちゃくだつ	着脱
ちゃくそう	着想
ちゃくせき	着席
ちゃくせい	着生
ちゃくすい	着水
ちゃくしょく	着色
ちゃくしゅつ	嫡出
ちゃくしゅ	着手
ちゃくじつ	着実
ちゃくし	嫡子
ちゃくがん	着眼
ちゃくい	着衣
ちゃく	着
ちゃき	茶器
ちゃいろ	茶色
ちゃーはん	炒飯
ちゃ	茶
ちめいど	知名度
ちめい	致命
ちめい	地名
ちめい	知命
ちめい	知名
ちみもうりょう	魑魅魍魎
ちみつ	緻密
ちまよ	血迷
ちまた	巷
ちまき	粽
ちほうさい	地方債
ちほう	痴呆
ちほう	地方
ちへん	地変
ちへい	地平
ちぶさ	乳房
ちぶ	恥部
ちひょう	地表
ちばん	地番
ちばし	血走
ちはい	遅配
ちのう	知能
ちねつ	地熱
ちにちは	知日派
ちなみに	因みに
ちな	因
ちどり	千鳥
ちとせ	千歳
ちどうせつ	地動説
ちてん	地点
ちてき	知的
ちてい	地底
ちっそく	窒息
ちっそ	窒素
ちつじょ	秩序
ちっきょ	蟄居
ちつ	膣
ちちゅう	地中
ちぢま	縮ま
ちちばなれ	乳離れ
ちちおや	父親
ちぢ	縮
ちち	父
ちち	乳
ちち	遅々
ちだい	地代
ちたい	遅滞
ちたい	地帯
ちそう	馳走
ちそう	地層
ちせつ	稚拙
ちせい	知性
ちすじ	血筋
ちすい	治水
ちず	地図
ちじん	知人
ちじょく	恥辱
ちじょう	痴情
ちじょう	地上
ちしつ	地質
ちじく	地軸
ちしき	知識
ちしお	血潮
ちじ	知事
ちし	致死
ちさん	遅参
ちさい	地裁
ちこく	遅刻
ちご	稚児
ちけん	知見
ちけい	地形
ちくろく	逐鹿
ちくのう	蓄膿
ちくねん	逐年
ちくでんき	蓄電器
ちくでん	蓄電
ちくぞう	築造
ちくせき	蓄積
ちくじょう	築城
ちくじ	逐次
ちくさん	畜産
ちぐさ	千草
ちくいち	逐一
ちく	地区
ちぎり	契
ちきゅうぎ	地球儀
ちきゅう	地球
ちき	知己
ちかん	置換
ちかん	痴漢
ちからわざ	力業
ちからもち	力持ち
ちからぶそく	力不足
ちからづよ	力強
ちからぞえ	力添え
ちから	力
ちかよ	近寄
ちかみち	近道
ちかば	近場
ちかてつ	地下鉄
ちかづけ	近付け
ちかづけ	近づけ
ちかづ	近付
ちかぢかの	近々の
ちかぢかと	近々と
ちかぢか	近々
ちかしつ	地下室
ちかし	近し
ちかごろ	近頃
ちかけい	地下茎
ちがく	地学
ちかく	地殻
ちかく	知覚
ちかく	近く
ちがえ	違え
ちがいな	違いな
ちかい	地階
ちが	違
ちか	地価
ちか	地下
ちか	誓
ちか	近
ちえん	遅延
ちえん	地縁
ちえぶくろ	知恵袋
ちえ	知恵
ちいさな	小さな
ちいさ	小さ
ちいき	地域
ちい	地衣
ちい	地位
ちあん	治安
ぢ	痔
ち	地
ち	知
ち	値
ち	治
ち	散
ち	血
だんわ	談話
だんろ	暖炉
たんれん	鍛錬
たんれい	端麗
だんりょく	弾力
たんりょく	胆力
だんりゅう	暖流
だんらく	段落
たんらく	短絡
たんようき	単葉機
だんゆう	男優
たんもの	反物
だんめん	断面
たんむ	坦務
たんまつ	端末
たんぽぽ	蒲公英
だんぼう	暖房
たんぼう	探訪
たんぽ	担保
たんぼ	田圃
たんぼ	田んぼ
だんぺん	断片
たんぺん	短辺
たんぺん	短編
たんぺん	短篇
たんぶん	短文
たんぶん	単文
たんぷく	単複
たんぴん	単品
たんぴょう	短評
たんび	耽美
だんぱつ	断髪
たんぱく	蛋白
たんぱく	淡白
たんぱ	短波
たんのう	胆嚢
たんのう	堪能
だんねん	断念
たんねん	丹念
だんねつざい	断熱材
たんにん	担任
たんなる	単なる
だんな	旦那
だんどり	段取り
だんとつ	断トツ
たんどく	単独
たんどく	丹毒
たんとうちょくにゅう	単刀直入
だんとうだい	断頭台
たんとうしゃ	担当者
だんどう	弾道
だんとう	暖冬
だんとう	弾頭
たんとう	短刀
たんとう	担当
たんでん	炭田
たんてん	端点
たんでき	耽溺
たんてき	端的
だんてい	断定
たんてい	探偵
たんちょうづる	丹頂鶴
だんちょう	断腸
だんちょう	団長
たんちょう	短調
たんちょう	単調
たんちょう	丹頂
だんちゃく	弾着
だんちがい	段違い
だんち	団地
たんち	探知
だんだん	段々
たんたん	淡々
だんたい	団体
たんだい	短大
たんたい	単体
だんぞく	断続
たんそく	短足
たんそく	嘆息
だんそう	断層
たんぞう	鍛造
たんそ	炭素
だんぜん	断然
だんせん	断線
たんぜん	端然
たんぜん	丹前
たんせん	単線
だんぜつ	断絶
たんせき	胆石
だんせいたい	弾性体
だんせい	男声
だんせい	男性
だんせい	弾性
たんせい	端正
たんせい	丹青
たんせい	丹精
たんすう	単数
たんすい	淡水
たんす	箪笥
たんしん	短針
たんしん	単身
たんじょうび	誕生日
だんじょう	壇上
だんしょう	談笑
たんじょう	誕生
たんしょう	短小
たんしょう	探勝
だんじょ	男女
たんしょ	端緒
たんしょ	短所
たんじゅん	単純
たんしゅく	短縮
たんじゅう	胆汁
たんじゅう	短銃
だんしゃく	男爵
たんしゃ	単車
だんじて	断じて
だんじき	断食
たんじかん	短時間
だんじ	男児
だんし	男子
たんし	端子
たんさん	炭酸
たんざく	短冊
たんさく	探索
だんさい	断裁
たんさい	淡彩
だんさ	段差
たんざ	端座
たんさ	探査
だんこん	男根
だんこん	弾痕
だんごばな	だんご鼻
だんごう	談合
だんこう	断行
だんこう	断交
だんこう	団交
たんこう	炭鉱
たんこう	炭坑
たんこう	単行
だんご	団子
だんこ	断固
たんご	単語
だんげん	断言
たんげん	単元
たんけん	探険
たんけん	探検
だんけつ	団結
たんげい	端倪
たんく	短躯
たんきゅう	探究
たんきゅう	探求
だんぎ	談議
だんぎ	談義
だんき	暖気
たんき	短気
たんき	短期
だんがん	弾丸
たんがん	嘆願
だんがい	断崖
だんがい	弾劾
だんかい	段階
だんかい	団塊
たんか	啖呵
たんか	短歌
たんか	炭化
たんか	担架
たんか	単価
たんいつか	単一化
たんいつ	単一
たんい	単位
だんあつ	弾圧
だん	談
だん	段
だん	暖
だん	断
だん	弾
だん	壇
だん	団
たん	反
たん	胆
たん	短
たん	嘆
たん	単
たわら	俵
たわむれ	戯れ
たわごと	戯言
だれしも	誰しも
たれさが	垂れ下が
だれ	誰
たれ	垂れ
たる	樽
だりょく	惰力
たりょう	多量
たりゅうじあい	他流試合
たりき	他力
たり	足り
だらく	堕落
たら	鱈
たら	垂ら
たよりな	頼りな
たより	便り
たよう	多用
たよう	多様
たよ	頼
たやす	容易
たや	絶や
たもつ	保
ためんたい	多面体
ためん	多面
ためん	他面
ためし	例
ためいき	ため息
だめ	溜め
だめ	駄目
ため	溜め
ため	溜
ため	貯め
ため	試
ため	矯め
ため	為
たむろ	屯
たむし	田虫
だみごえ	だみ声
たみ	民
たまわ	賜わ
たまわ	賜
だまり	溜り
たまり	溜
たまもの	賜
たまむし	玉虫
たまのこし	玉の輿
たまねぎ	玉葱
たまてばこ	玉手箱
たまつき	球撞き
だましと	だまし取
たましい	魂
たまご	卵
たまご	玉子
たまげ	魂消
だま	黙
たま	溜
たま	貯
たま	弾
たま	珠
たま	賜
たま	玉
たま	給
たま	球
たま	丸
だぼく	打撲
たほうせい	多峰性
たぼう	多忙
たほう	他方
だほ	拿捕
たべん	多弁
たべもの	食べ物
たべ	食べ
たぶん	多分
たぶん	他聞
たびびと	旅人
たびたび	度々
たびだ	旅立
たびじ	旅路
たびさき	旅先
たびかさな	度重な
だび	荼毘
たび	旅
たび	度
たび	足袋
たばね	束ね
たはつ	多発
たばこ	煙草
たばか	謀
たばい	多売
だは	打破
たば	束
たのもし	頼もし
たのみこ	頼み込
たのし	愉し
たのし	楽し
たのう	多能
たの	頼
たねん	多年
たねあかし	種明し
たねあかし	種明かし
たね	種
たね	胤
たぬき	狸
たにん	他人
たにま	谷間
たにがわ	谷川
だに	谷
たに	谷
たなん	多難
たなび	棚引
たなばた	七夕
たなざらし	店晒し
たなざらし	店ざらし
たなごころ	掌
たなおろし	棚卸し
たないた	棚板
たなあげ	棚上げ
たな	店
たな	棚
たどりつ	たどり着
たどく	多読
たとえば	例えば
たとえ	例え
だとうせい	妥当性
たどうし	他動詞
だとう	打倒
だとう	妥当
たど	辿
だでん	打電
たてやくしゃ	立役者
たてや	建屋
たてもの	建物
たてまつ	奉
たてまし	建増し
だてまき	伊達巻
たてまえ	建前
たてなが	縦長
たてつぼ	建坪
たてつけ	立付け
たてつけ	建てつけ
たてつ	盾突
たてじま	縦縞
たてこも	立てこも
たてこ	たて込
たてかけ	立てかけ
たてかえ	立替
たてかえ	立て替え
たてかえ	建て替え
たてうり	建売り
たてうち	館内
だて	立て
だて	伊達
たで	蓼
たて	立て
たて	点て
たて	盾
たて	楯
たて	縦
たて	建て
たて	舘
たて	館
だつりゃく	奪略
だつらく	脱落
だつもう	脱毛
たつみ	巽
たつまき	竜巻
だつぼう	脱帽
たつぶん	達文
たっぴつ	達筆
だっぴ	脱皮
たづな	手綱
たつどし	辰年
たっと	尊
たっと	貴
だっちょう	脱腸
だっちゃく	脱着
たっち	タッチ
だったい	脱退
だっそう	脱走
だっせん	脱線
だつぜい	脱税
たっせい	達成
だっすい	脱水
たつじん	達人
だっしょく	脱色
だっしゅつ	脱出
だっしゅう	脱臭
たっしゃ	達者
だつじ	脱字
だっし	脱脂
だつごく	脱獄
だっこく	脱穀
だっこう	脱肛
だっこう	脱稿
たっけん	卓見
たっきゅうびん	宅急便
だっきゅう	脱臼
たっきゅう	卓球
だっきゃく	脱却
だっかく	奪格
だっかい	脱会
だっかい	奪回
だつい	脱衣
だつ	建つ
だっ	脱
たつ	龍
たつ	竜
たつ	辰
たっ	達
だちん	駄賃
だちょう	駝鳥
たちよ	立ち寄
たちむか	立ち向か
たちみ	立見
たちまわ	立ち回
たちまち	立待ち
たちばなし	立ち話
たちばな	橘
たちはだか	立ちはだか
たちば	立場
たちの	立ち退
たちなら	立ち並
たちなら	建ち並
たちなお	立ち直
たちどま	立ち止ま
たちすく	立ちすく
たちさ	立ち去
たちぐい	立ち食い
たちぎき	立ち聞き
たちぎえ	立ち消え
たちき	断ち切
たちおくれ	立ち後れ
たちおうじょう	立往生
たちうり	立売
たちい	立居
たちい	立ち入
たちい	立ち居
たちあげ	立ち上げ
たちあがり	立上り
たちあが	立ち上が
たちあいにん	立会人
たちあ	立ち会
たち	太刀
たち	多値
たち	質
ただよわ	漂わ
ただよ	漂
たたみこ	畳み込
たたみかけ	畳み掛け
たたみ	畳
ただちに	直ちに
ただしがき	但書き
ただし	但し
ただし	但
ただし	正し
ただごと	唯事
たたきだ	たたき出
たたきこ	たたき込
たたか	闘
たたか	戦
たたえ	湛え
たたえ	称え
たたえ	讃え
ただいま	只今
ただいま	ただ今
ただい	多大
たたい	多体
ただ	只
ただ	正
ただ	質
たた	祟
たた	叩
たた	多々
たた	畳
だそく	蛇足
たせん	他薦
だせき	打席
だせい	惰性
たぜい	多勢
たずね	訪ね
たずね	尋ね
たずさわ	携わ
たずさえ	携え
たすけだ	助け出
たすけあ	助け合
たすけ	助け
たすか	助か
たすうけつ	多数決
たすう	多数
だしん	打診
たじょう	多情
たしょう	多祥
たしょう	多少
たしょう	他生
だじゅん	打順
たしゅつ	他出
たじゅう	多重
たしゅ	多種
たしゅ	他種
だじゃれ	駄洒落
だじゃく	懦弱
だしゃ	打者
たしゃ	多謝
たしゃ	他者
たしゃ	他社
だしもの	出し物
だしぬ	出し抜
たじつ	他日
たしつ	多湿
たしざん	足算
たしざん	足し算
だしき	出し切
たしかめ	確かめ
たしか	確か
だしいれ	出し入れ
だしあ	出し合
だし	出汁
だし	山車
たじ	多事
たじ	他事
たし	他誌
たし	他紙
たし	足し
たざんのいし	他山の石
ださん	打算
たさつ	他殺
ださく	駄作
たさく	多作
たさい	多才
たさい	多彩
たざ	打坐
たごん	他言
たこく	他国
たこうしき	多項式
だこう	蛇行
たこう	多幸
たこう	他校
たこ	鮹
たこ	蛸
たこ	凧
だけん	打鍵
たげん	多言
たげん	多元
たけん	他県
たけひご	竹ひご
たけばやし	竹林
だけつ	妥結
だげき	打撃
たげい	多芸
たけ	猛
たけ	長け
たけ	竹
たけ	他家
たけ	丈
たけ	岳
たくわえ	貯え
たくわえ	蓄え
だくりゅう	濁流
たくら	企
たくみ	匠
たくみ	巧み
たくまし	逞し
たくほん	拓本
たくばつ	卓抜
たくはつ	托鉢
たくはい	宅配
だくてん	濁点
たくち	宅地
たくそう	託送
たくせん	託宣
たくせつ	卓説
だくすい	濁水
たくしょく	拓殖
たくじょう	卓上
たくしゅつ	卓出
たくじ	託児
たくさん	沢山
だくおん	濁音
たくえつ	卓越
たくいつ	択一
たぐい	類
だく	諾
たぐ	手繰
たく	託
たく	托
たく	宅
たきょく	多極
たきょく	他局
だきょう	妥協
たきょう	他郷
たきび	焚火
たきだし	炊出し
だきしめ	抱き締め
だきしめ	抱きしめ
だきこ	抱き込
たきぎ	薪
たきがわ	滝川
だき	唾棄
たき	瀧
たき	滝
たき	多岐
たかん	多感
たからもの	宝物
たからじま	宝島
たからか	高らか
たから	宝
たがや	耕
たかめ	高め
たかま	高ま
たかぶ	亢ぶ
たかぶ	昂ぶ
たかのぞみ	高望み
たがね	鏨
たかね	高値
たかなみ	高波
たかな	高鳴
たかとび	高飛び
たかっけい	多角形
たかだか	高々
たかだい	高台
たかしお	高潮
たかさご	高砂
たかくちゅう	多角柱
たかくすいだい	多角錐台
たかくすい	多角錐
たかくけい	多角形
たがく	多額
たかく	多角
たがいちがい	互い違い
だかい	打開
たがい	互い
たかい	他界
たが	違
たか	鷹
たか	多寡
たか	高
たおれ	倒れ
たお	倒
だえんこ	楕円弧
だえん	楕円
たえま	絶え間
たえま	絶えま
たえなる	妙なる
たえず	絶えず
だえき	唾液
たえ	耐え
たえ	絶え
たえ	堪え
たう	多雨
たいわ	対話
たいろう	大老
たいりん	大輪
たいりょく	体力
たいりょう	大量
たいりゅう	滞留
たいりゅう	対流
たいりゃく	大略
だいりてん	代理店
たいりつ	対立
だいりせき	大理石
たいりく	大陸
だいり	内裏
だいり	代理
たいらげ	平らげ
たいら	平ら
たいら	平
たいようけい	太陽系
だいよう	代用
たいよう	大要
たいよう	大洋
たいよう	耐用
たいよう	太陽
たいよ	貸与
だいやく	代役
たいやく	大役
たいやく	対訳
だいもん	大門
だいもん	代紋
だいもく	題目
たいもう	体毛
たいめん	対面
たいめん	体面
だいめいし	代名詞
だいめい	題名
だいみょう	大名
たいまん	怠慢
たいまい	大枚
たいま	大麻
たいま	タイマ
だいほん	台本
たいぼく	大木
たいぼう	大望
たいぼう	待望
たいぼう	耐乏
たいほう	大鵬
たいほう	大砲
たいほ	逮捕
たいほ	退歩
だいべん	大便
だいべん	代弁
たいへん	大変
たいべつ	大別
たいべい	対米
たいへい	太平
だいぶん	大分
だいぶぶん	大部分
だいぶつ	大仏
たいぶつ	対物
だいふくちょう	大福帳
だいふく	大福
たいふう	台風
だいぶ	大分
たいぶ	大部
だいひょう	代表
たいびょう	大病
だいひつ	代筆
たいひ	退避
たいひ	対比
たいひ	堆肥
たいばん	胎盤
たいはん	大半
だいはっかい	大発会
たいばつ	体罰
たいはい	頽廃
たいは	大破
だいのうかい	大納会
だいのう	大脳
だいのう	代納
たいのう	滞納
たいねつ	耐熱
たいにん	大任
たいにん	退任
だいにゅう	代入
たいにち	滞日
たいにち	対日
だいに	第二
だいなし	台無し
だいなごん	大納言
たいない	胎内
たいない	対内
たいない	体内
だいどころ	台所
たいとく	体得
だいとうりょう	大統領
たいどう	胎動
たいとう	台頭
たいとう	帯刀
たいとう	対等
たいど	態度
たいと	泰斗
たいでん	帯電
たいてき	大敵
たいてい	大抵
だいちょう	大腸
だいちょう	台帳
たいちょう	隊長
たいちょう	体長
たいちょう	体調
たいちょ	大著
だいち	大地
だいち	台地
たいち	対置
たいち	対地
だいたん	大胆
たいだん	退団
たいだん	対談
だいだいてき	大々的
だいだい	橙
だいだい	代々
だいたい	大隊
だいたい	大体
だいたい	代替
たいだ	怠惰
だいそれた	大それた
たいそく	体側
たいぞう	退蔵
たいそう	大層
たいそう	大喪
たいそう	体操
たいぜん	泰然
たいせん	大戦
たいせん	対戦
だいせつ	大雪
たいせつ	大雪
たいせつ	大切
たいせき	退席
たいせき	滞積
たいせき	堆積
たいせき	体積
たいせい	大成
たいせい	大勢
たいせい	態勢
たいせい	耐性
たいせい	体勢
たいせい	体制
だいすき	大好き
だいすう	台数
だいすう	代数
たいすい	耐水
だいず	大豆
だいじん	大臣
たいじん	対人
たいしん	耐震
たいしょくきん	退職金
たいしょくかん	大食漢
たいしょく	褪色
たいしょく	大食
たいしょく	退職
だいじょうぶ	大丈夫
たいしょうがい	対象外
だいしょう	大小
だいしょう	代償
たいじょう	退場
たいしょう	大賞
たいしょう	大将
たいしょう	大勝
たいしょう	対象
たいしょう	対称
たいしょう	対症
たいしょう	対照
だいしょ	代書
たいしょ	大暑
たいしょ	対処
たいしゅつ	退出
だいしゅくしゃく	大縮尺
たいじゅう	体重
たいしゅう	大衆
たいしゅう	体臭
たいじゅ	大樹
たいしゃく	貸借
だいしゃ	台車
たいしゃ	大赦
たいしゃ	代謝
たいしゃ	退社
たいしつ	体質
たいした	大した
たいしかん	大使館
だいじ	題字
だいじ	大事
だいし	台紙
たいじ	退治
たいじ	胎児
たいじ	対峙
たいし	大志
たいし	大使
たいし	太子
たいさん	退散
たいさく	大作
たいさく	対策
だいざい	題材
たいざい	滞在
たいざ	対座
たいさ	大差
たいさ	大佐
だいこん	大根
だいごみ	醍醐味
たいこばん	太鼓判
たいこばら	太鼓腹
たいこしょう	耐故障
だいこく	大黒
たいこく	大国
だいこう	代講
だいこう	代行
たいこう	大綱
たいこう	大公
たいこう	退行
たいこう	対抗
たいこ	太鼓
たいこ	太古
たいげん	体言
たいげん	体現
たいけん	大圏
たいけん	体験
たいけつ	対決
だいけい	台形
たいけい	大慶
たいけい	体系
たいけい	体型
たいぐん	大群
たいくつ	退屈
たいぐう	待遇
たいぐう	対偶
たいくう	滞空
だいく	大工
たいく	体躯
だいきん	代金
たいきん	大金
たいきょくけん	太極拳
たいきょく	大局
たいきょく	対極
たいきょく	対局
たいきょく	太極
たいきょう	胎教
たいきょ	大挙
たいきょ	退去
だいきゅう	代休
たいきゅう	耐久
たいきゃく	退却
たいぎめいぶん	大義名分
だいきぼ	大規模
たいきけん	大気圏
たいき	大気
たいき	待機
たいかんしき	戴冠式
だいかん	大寒
だいかん	代官
たいがん	対岸
たいかん	退官
たいかん	戴冠
たいかん	耐寒
たいかくせん	対角線
だいがくせい	大学生
だいがくいん	大学院
だいがく	大学
たいがく	退学
たいかく	対格
たいかく	体格
だいがえ	代替
たいがい	大概
たいがい	対外
たいがい	体外
たいかい	大海
たいかい	大会
たいかい	退会
だいか	代価
たいが	大河
たいか	大過
たいか	大火
たいか	大家
たいか	退化
たいか	滞貨
たいか	耐火
たいおん	体温
だいおうじょう	大往生
たいおう	対応
だいえん	大円
たいえき	退役
たいえき	体液
たいえい	退嬰
たいいん	隊員
たいいん	退院
だいいち	第一
たいいくかん	体育館
たいいく	体育
たいいきち	大域値
たいいき	大域
たいいき	帯域
たいい	大意
たいい	退位
たいい	体位
だいあん	代案
たいあん	大安
たいあん	対案
たいあたり	体当り
だい	題
だい	大
だい	台
だい	代
たい	鯛
たい	隊
たい	帯
たい	対
たい	体
たい	他意
たあいな	他愛な
たあい	他愛
だ	抱
だ	田
だ	出
た	立
た	焚
た	発
た	田
た	断
た	他
た	足
た	絶
た	炊
た	裁
た	建
た	経
た	起
そんりつ	村立
そんりつ	存立
そんらく	村落
そんもう	損耗
ぞんめい	存命
そんみん	村民
そんぼう	存亡
ぞんぶん	存分
そんとく	損得
そんちょう	村長
そんちょう	尊重
そんち	存置
そんたく	忖度
そんだい	尊大
そんぞく	尊属
そんぞく	存続
そんしょく	遜色
そんしょう	損傷
そんしょう	尊称
そんしつ	損失
ぞんじあげ	存じ上げ
そんざい	存在
そんげん	尊厳
そんけい	尊敬
ぞんがい	存外
そんがい	損害
そんかい	損壊
そんえき	損益
そんえい	村営
ぞん	存
そん	村
そん	損
そん	存
そろえ	揃え
そろ	揃
それぞれ	夫々
それぞれ	其々
それ	逸れ
そりゅうし	素粒子
そりゃく	粗略
そりかえ	反り返
そらに	空似
そらなみだ	空涙
そらおそろし	そら恐ろし
そら	反ら
そら	空
そら	逸ら
そら	逸
そよかぜ	そよ風
そようちょう	租庸調
そよう	素養
そや	粗野
そめもの	染物
そめつけ	染め付け
そめだ	染め出
そめ	染め
そめ	初め
そむ	背
そまつ	粗末
そま	染ま
そぼく	素朴
そほうか	素封家
そぼう	粗暴
そほう	粗放
そぼ	祖母
そふぼ	祖父母
そふ	祖父
そびょう	素描
そびえた	そびえ立
そばこ	蕎麦粉
そばこ	そば粉
そば	側
そば	蕎麦
そのよう	その様
そのた	その他
そのご	その後
その	其
その	園
そね	嫉
そなわ	備わ
そなえつけ	備え付け
そなえ	備え
そなえ	供え
そとまわり	外回り
そとづら	外面
そとがわ	外側
そと	外
そてい	措定
そで	袖
そつろん	卒論
そっぷがた	ソップ形
そっとう	卒倒
そっちょく	率直
そっちゅう	卒中
そっせん	率先
そつじゅ	卒寿
ぞっこく	属国
そっこく	即刻
そっこうじょ	測候所
ぞっこう	続行
そっこう	速攻
そっこう	即効
そっけつ	即決
そっきん	即金
そっきん	側近
そつぎょうしき	卒業式
そつぎょう	卒業
そっきょう	即興
そっきゅう	速急
そっき	速記
ぞっか	俗化
そつう	疎通
そつ	卒
そち	措置
そだてあげ	育て上げ
そだて	育て
そだい	粗大
そだ	育
そそりた	そそり立
そそのか	唆
そそぎぐち	注ぎ口
そそう	粗相
そそ	注
そそ	楚々
そそ	唆
そせん	祖先
そぜい	租税
そせい	蘇生
そせい	組成
そせい	粗製
そせい	塑性
そすう	素数
そすい	疎水
そしょく	粗食
そじょう	溯上
そじょう	俎上
そじょう	訴状
そしょう	訴訟
そしゃく	咀嚼
そしゃく	租借
そしな	粗品
そしつ	素質
そしき	組織
そじ	素地
そし	誹
そし	阻止
そし	素子
そざつ	粗雑
そざい	素材
そさい	蔬菜
そこびき	底引き
そこびえ	底冷え
そこね	底値
そこね	損ね
そこな	損な
そこぢから	底力
そこく	祖国
そこう	素行
そこいじ	底意地
そご	齟齬
そこ	底
そげき	狙撃
ぞくろん	俗論
そくろう	足労
そくりょく	速力
ぞくりょう	属領
そくりょう	測量
ぞくりゅう	俗流
ぞくらく	続落
そくめん	側面
ぞくほう	続報
そくほう	速報
ぞくへん	続編
そくぶつてき	即物的
ぞくぶつ	俗物
ぞくはつ	続発
そくはつ	即発
そくばく	束縛
そくばい	即売
ぞくとう	続騰
ぞくとう	続投
そくとう	速答
そくとう	即答
そくど	速度
そくど	測度
そくてい	測定
ぞくち	属地
そくち	測地
そくだん	即断
そくたつ	速達
そくだく	即諾
そくたい	束帯
ぞくぞく	続々
ぞくせつ	俗説
そくせき	足跡
そくせき	即席
ぞくせい	属性
そくせい	促成
ぞくじん	属人
ぞくしん	続伸
そくしん	促進
ぞくしょう	俗称
ぞくしゅつ	続出
ぞくしゅう	俗習
そくじつ	即日
ぞくじ	俗字
そくじ	即時
そくし	即死
そくし	側視
そくざ	即座
ぞくご	俗語
ぞくぐん	賊軍
そくおん	促音
そくおう	即応
そくいん	惻隠
そくい	即位
ぞくあく	俗悪
ぞく	族
ぞく	賊
ぞく	属
ぞく	俗
そく	足
そく	束
そく	息
そく	即
そく	則
そきゅう	遡及
そかく	組閣
そかく	疎隔
そがい	阻害
そがい	疎外
そかい	租界
そかい	疎開
そえん	疎遠
そえ	添え
ぞうわい	贈賄
そうわ	総和
そうわ	挿話
そうろん	総論
そうろうぶん	候文
そうろう	早漏
そうろう	候
そうれつ	葬列
そうれつ	壮烈
そうるい	走塁
ぞうりん	造林
ぞうりょく	増力
そうりょく	総力
そうりょう	送料
そうりょう	総領
そうりょう	総量
そうりょ	僧侶
そうりふ	総理府
そうりつ	創立
ぞうり	草履
そうり	総理
そうらん	騒乱
そうらん	総覧
そうよう	装用
ぞうよ	贈与
そうめん	素麺
そうめい	聰明
そうめい	聡明
ぞうむし	象虫
そうむ	総務
そうほうこう	双方向
そうほう	双方
ぞうほ	増補
そうほ	相補
そうべつ	送別
ぞうふく	増幅
そうふう	送風
そうふ	送付
ぞうびん	増便
そうびょう	躁病
そうひょう	総評
そうび	装備
そうばん	早晩
そうはん	相反
ぞうはつ	増発
そうはい	送配
そうば	相場
そうは	走破
そうは	掻爬
そうねん	想念
そうねん	壮年
そうにゅう	挿入
ぞうに	雑煮
そうなん	遭難
そうとく	総督
ぞうとう	贈答
そうどう	騒動
そうとう	総統
そうとう	相当
そうとう	掃討
そうとう	双頭
そうと	壮途
そうと	壮図
そうでん	送電
そうてん	装填
そうてん	争点
ぞうてい	贈呈
そうてい	送呈
そうてい	装丁
そうてい	想定
そうで	総出
そうつい	双対
ぞうちょう	増長
そうちょう	荘重
そうちょう	総長
そうちょう	早朝
そうちゃく	装着
ぞうちく	増築
そうち	送致
そうち	装置
そうだんしょ	相談所
そうだん	相談
そうだつ	争奪
そうたつ	送達
そうだち	総立ち
そうだか	総高
そうたいてき	相対的
そうたいち	相対値
ぞうだい	増大
そうだい	総代
そうだい	壮大
そうたい	総体
そうたい	相対
そうたい	早退
そうだ	操舵
そうぞく	相続
そうそく	総則
そうぞうし	騒々し
そうぞう	送像
そうぞう	想像
そうぞう	創造
そうそう	錚々
そうそう	草々
そうそう	早々
ぞうせん	造船
そうぜん	騒然
ぞうせつ	増設
そうぜつ	壮絶
そうせつ	創設
そうせいじ	双生児
ぞうぜい	増税
ぞうせい	造成
そうぜい	総勢
そうせい	早逝
そうせい	早世
そうせい	叢生
そうせい	創製
そうすう	総数
ぞうすい	増水
ぞうすい	雑炊
そうず	挿図
ぞうしん	増進
そうしん	送信
そうしん	装身
そうしん	痩身
ぞうしょく	増殖
そうしょく	装飾
そうしょく	草食
ぞうしょう	蔵相
そうじょう	騒擾
そうじょう	相乗
そうじょう	僧上
そうしょう	総称
そうしょう	宗匠
ぞうしょ	蔵書
そうしょ	草書
そうしゅん	早春
そうしゅつ	送出
そうじゅく	早熟
ぞうしゅうわい	贈収賄
そうしゅうへん	総集編
ぞうしゅう	増収
そうじゅう	操縦
そうじゅ	送受
そうしゃ	走者
そうしゃ	操車
そうしゃ	掃射
そうしゃ	奏者
そうじて	総じて
そうしつ	喪失
そうじしょく	総辞職
そうしき	葬式
ぞうし	増資
そうじ	相似
そうじ	掃除
そうし	草紙
そうし	相思
そうし	創始
ぞうさん	増産
ぞうさつ	増刷
ぞうさく	造作
ぞうさく	増作
そうさく	捜索
そうさく	創作
そうざい	惣菜
そうさい	総裁
そうさい	相殺
ぞうさ	造作
そうさ	走査
そうさ	操作
そうさ	捜査
ぞうごん	雑言
そうごん	荘厳
そうこん	早婚
そうこく	相克
そうごう	総合
そうごう	相好
そうこう	霜降
そうこう	走行
そうこう	装甲
そうこう	草稿
そうこう	糟糠
そうこう	操行
そうこう	壮行
ぞうご	造語
そうご	相互
そうこ	倉庫
ぞうげん	増減
そうげん	草原
そうげん	創元
そうけん	送検
そうけん	壮健
ぞうけつ	増結
ぞうけい	造詣
ぞうけい	造形
そうげい	送迎
そうけい	総計
そうけい	早計
ぞうげ	象牙
そうけ	宗家
そうくつ	巣窟
そうぐう	遭遇
ぞうきん	雑巾
そうきん	送金
そうきょくせん	双曲線
そうきょくし	双極子
そうきょく	総局
ぞうきょう	増強
そうぎょう	操業
そうぎょう	創業
そうきょ	壮挙
そうきゅう	早急
ぞうきばやし	雑木林
ぞうき	臓器
ぞうき	雑木
そうぎ	葬儀
そうぎ	争議
そうき	早期
そうき	想起
そうがんきょう	双眼鏡
ぞうかん	増刊
そうかん	送還
そうかん	総監
そうかん	相関
そうかん	相姦
そうかん	層間
そうかん	壮観
そうかん	創刊
そうかつ	総轄
そうかつ	総括
ぞうがく	増額
そうがく	総額
そうがい	霜害
そうかい	総会
そうかい	掃海
そうかい	爽快
そうかい	壮快
ぞうか	造花
ぞうか	増加
そうが	挿画
そうおん	騒音
そうおう	相応
ぞうお	憎悪
ぞうえん	造園
ぞうえん	増援
ぞうえき	増益
ぞうえい	造営
そううつ	躁鬱
ぞういん	増員
そういん	総員
そうい	相違
そうい	創痍
そうい	創意
そうあん	草案
そうあい	相愛
ぞう	蔵
ぞう	増
ぞう	像
ぞう	象
そう	荘
そう	草
そう	総
そう	相
そう	槽
そう	層
そう	宋
そう	奏
そう	僧
そう	宗
そいんすう	素因数
そいんし	素因子
そいん	訴因
そいん	素因
そあく	粗悪
そ	反
そ	添
そ	剃
そ	素
そ	祖
そ	沿
せんろ	線路
せんれん	洗練
ぜんれつ	前列
せんれつ	鮮烈
ぜんれき	前歴
ぜんれい	前例
せんれい	洗礼
せんれい	先例
ぜんりょく	全力
せんりょく	戦力
ぜんりょう	善良
せんりょう	線量
せんりょう	染料
せんりょう	占領
せんりょ	浅慮
せんりょ	千慮
せんりゅう	川柳
ぜんりゃく	前略
せんりゃく	戦略
せんりつ	旋律
せんりつ	戦慄
せんりがん	千里眼
せんり	戦利
せんり	千里
ぜんら	全裸
ぜんよう	全容
ぜんよう	善用
せんよう	専用
せんゆう	戦友
せんゆう	専有
せんゆう	占有
ぜんやく	全訳
せんやく	先約
ぜんや	前夜
せんもんか	専門家
せんもん	専門
せんもう	譫妄
せんもう	繊毛
せんめんき	洗面器
ぜんめん	全面
ぜんめん	前面
せんめん	洗面
ぜんめつ	全滅
せんめつ	殲滅
せんめい	鮮明
せんむ	専務
せんみん	選民
せんみん	賎民
せんまけ	先負
せんぼつ	戦没
せんぼうきょう	潜望鏡
ぜんぽう	前方
ぜんぼう	全貌
せんぽう	旋法
せんぽう	戦法
せんぽう	先方
せんぼう	羨望
ぜんぺん	全編
ぜんぺん	前編
せんべん	先鞭
せんべつ	餞別
せんべつ	選別
せんぺい	尖兵
せんべい	煎餅
ぜんぶん	全文
ぜんぶん	前文
せんぶん	線分
せんぷく	潜伏
せんぷうき	扇風機
せんぷう	旋風
ぜんぶ	全部
せんぷ	戦斧
せんぷ	先負
せんぶ	先負
ぜんぴん	全品
ぜんびん	全便
ぜんびん	前便
せんびん	船便
せんびょうしつ	腺病質
せんぴょう	選評
せんぴょう	線表
せんびょう	線描
せんぴ	戦費
せんび	船尾
ぜんぱん	全般
ぜんぱん	前半
ぜんはん	前半
せんぱん	戦犯
せんぱん	先般
せんばん	旋盤
せんばん	千万
せんばづる	千羽鶴
せんぱつ	洗髪
せんぱつ	先発
せんばつ	選抜
せんぱく	船舶
ぜんぱい	全敗
ぜんぱい	全廃
せんぱい	先輩
せんばい	専売
せんば	船場
ぜんのう	前納
せんのう	洗脳
ぜんねんど	前年度
せんねん	専念
ぜんにん	善人
ぜんにん	前任
せんにん	選任
せんにん	専任
せんにん	仙人
せんにゅうかん	先入観
せんにゅう	潜入
ぜんにほん	全日本
ぜんにちせい	全日制
せんない	船内
せんとうき	戦闘機
ぜんどう	蠕動
ぜんどう	善導
ぜんとう	全島
せんどう	船頭
せんどう	先導
せんとう	銭湯
せんとう	戦闘
せんとう	尖塔
せんとう	先頭
ぜんど	全土
ぜんと	前途
せんど	鮮度
せんど	先途
せんと	遷都
ぜんてん	全店
せんでん	宣伝
せんてん	尖点
せんてん	先天
ぜんでら	禅寺
せんてつ	銑鉄
せんでき	洗滌
ぜんてい	前提
せんてい	剪定
せんてい	選定
せんて	先手
ぜんつう	全通
ぜんちょう	全長
ぜんちょう	前兆
せんちょう	船長
ぜんちょ	前著
せんちゃく	先着
せんちゃ	煎茶
ぜんちし	前置詞
ぜんち	全治
せんち	戦地
ぜんたん	前端
せんだん	剪断
せんだん	船団
せんだん	栴檀
せんたん	戦端
せんたん	尖端
せんたん	先端
ぜんだま	善玉
せんたくし	選択肢
せんたくき	洗濯機
せんたく	選択
せんたく	洗濯
ぜんだい	前代
ぜんたい	全体
せんだい	先代
せんたい	船体
せんた	センタ
ぜんそく	喘息
せんぞく	専属
せんぞがえり	先祖返り
ぜんぞう	漸増
ぜんそう	前奏
せんそう	戦争
せんぞ	先祖
せんせんしゅう	先々週
ぜんぜん	全然
ぜんせん	全線
ぜんせん	前線
せんぜん	戦前
せんせん	戦線
せんせん	宣戦
ぜんせき	全席
せんせき	船籍
せんせいじゅつ	占星術
ぜんせいき	全盛期
ぜんせい	全盛
せんせい	宣誓
せんせい	先生
せんすいかん	潜水艦
せんすい	潜水
せんす	扇子
せんしんこく	先進国
ぜんしん	全身
ぜんしん	漸進
ぜんしん	前進
ぜんしん	前身
せんじん	千尋
せんじん	先人
せんしん	専心
せんしん	先進
せんしょくたい	染色体
せんしょく	染色
せんしょく	染織
ぜんしょうせん	前哨戦
ぜんしょうきごう	全称記号
ぜんしょう	全章
ぜんしょう	全焼
ぜんしょう	全勝
ぜんしょう	前章
せんじょう	船上
せんじょう	線上
せんじょう	煽情
せんじょう	洗浄
せんじょう	扇状
せんじょう	戦場
せんしょう	僭称
せんしょう	先勝
ぜんしょ	全書
ぜんしょ	善処
ぜんじゅつ	前述
せんじゅつ	戦術
せんじゅつ	先述
せんじゅつ	仙術
せんしゅつ	選出
せんしゅうらく	千秋楽
ぜんしゅう	禅宗
ぜんしゅう	全集
ぜんしゅう	前週
せんじゅう	専従
せんしゅう	選集
せんしゅう	専修
せんしゅう	先週
せんしゅ	選手
せんしゅ	船首
せんしゅ	専守
せんしゅ	先取
ぜんしゃ	全社
ぜんしゃ	前者
せんじゃ	選者
せんしゃ	戦車
ぜんじつ	全日
ぜんじつ	前日
せんじつ	先日
せんしつ	船室
ぜんじ	漸次
ぜんし	全紙
ぜんし	全市
せんじ	煎じ
せんじ	戦時
せんし	戦死
せんし	戦士
せんし	先史
せんさばんべつ	千差万別
ぜんさく	前作
せんさく	詮索
せんざいいちぐう	千載一遇
ぜんさい	前菜
せんざい	潜在
せんざい	洗剤
せんざい	千載
せんさい	繊細
せんさい	戦災
ぜんごさく	善後策
せんごくぶね	千石船
ぜんこく	全国
せんごく	戦国
せんこく	宣告
せんこく	先刻
ぜんこう	全校
ぜんこう	善行
ぜんこう	前項
せんこう	閃光
せんこう	選考
せんこう	線香
せんこう	穿孔
せんこう	潜航
せんこう	専攻
せんこう	先行
せんこう	先攻
ぜんご	前後
ぜんこ	全戸
せんご	戦後
ぜんげん	漸減
ぜんげん	前言
ぜんけん	全県
ぜんけん	全権
ぜんけん	全検
せんげん	選言
せんげん	宣言
せんけん	先見
ぜんげつ	前月
ぜんけつ	全血
せんげつ	先月
せんけつ	鮮血
せんけつ	先決
ぜんけい	全景
ぜんけい	全形
ぜんけい	前掲
ぜんけい	前傾
せんぐう	遷宮
ぜんく	全区
ぜんく	前駆
せんく	先駆
ぜんきん	漸近
ぜんきょく	全曲
ぜんきょく	全局
せんきょく	選曲
せんきょく	戦局
せんきょうし	宣教師
せんぎょう	専業
せんきょう	戦況
せんぎょ	鮮魚
せんきょ	選挙
せんきょ	占拠
せんきゃくばんらい	千客万来
せんきゃく	船客
ぜんき	全機
ぜんき	前記
ぜんき	前期
せんぎ	詮議
せんき	戦記
ぜんかん	全館
ぜんかん	全巻
せんがん	洗顔
せんかん	戦艦
ぜんがく	全額
ぜんがく	全学
せんがく	浅学
せんがく	先学
せんかく	先覚
ぜんかい	全開
ぜんかい	全快
ぜんかい	全壊
ぜんかい	全会
ぜんかい	前回
せんがい	選外
せんかい	旋回
ぜんか	前科
せんか	戦禍
せんか	戦火
せんか	戦果
せんか	専科
せんおう	専横
せんえつ	僭越
せんえき	戦役
ぜんえい	前衛
せんえい	尖鋭
せんえい	先鋭
ぜんいん	全員
せんいん	船員
ぜんいき	全域
ぜんい	善意
せんい	遷移
せんい	繊維
せんい	戦意
ぜんあく	善悪
ぜん	膳
ぜん	禅
ぜん	全
ぜん	善
ぜん	前
ぜん	千
せん	選
せん	線
せん	煎
せん	栓
せん	撰
せん	宣
せん	千
せわ	世話
せろん	世論
ぜろ	零
せりふ	台詞
せりあげ	せり上げ
せりあ	競り合
せり	芹
せめつけ	責めつけ
せめたて	責めたて
せめこ	攻め込
せめく	責苦
せめぎあ	せめぎ合
せめおと	攻め落と
せめ	責め
せめ	責
せめ	攻め
せみ	蝉
せまくるし	狭苦し
せま	迫
せま	狭
せぼね	背骨
せびろ	背広
ぜひ	是非
せばめ	狭め
せばま	狭ま
せのび	背伸び
ぜにん	是認
ぜに	銭
せなか	背中
せともの	瀬戸物
せとぎわ	瀬戸際
せと	瀬戸
せつわ	説話
せつりつ	設立
せつり	摂理
せつやく	節約
せつもん	設問
ぜつめつ	絶滅
ぜつめい	絶命
せつめい	説明
ぜつむ	絶無
ぜつみょう	絶妙
ぜっぽう	舌鋒
ぜつぼう	絶望
せっぽう	説法
せつぼう	切望
ぜっぺき	絶壁
せっぷん	接吻
せつぶん	節分
せっぷく	切腹
ぜっぴん	絶品
ぜっぴつ	絶筆
せつびご	接尾語
せつび	設備
せつび	接尾
ぜっぱん	絶版
せっぱん	折半
せっぱつま	切羽詰ま
せっぱく	切迫
せつな	刹那
せつな	切な
せっとく	説得
せつどう	摂動
せっとう	窃盗
せっとう	接頭
せつど	節度
せつでん	節電
せってん	接点
せってい	設定
せっちん	雪隠
ぜっちょう	絶頂
せっちょ	拙著
せっちゅう	折衷
せっちゃく	接着
せっち	設置
せつだん	切断
せったく	拙宅
ぜったいち	絶対値
ぜったいぜつめい	絶体絶命
ぜつだい	絶大
ぜったい	絶対
せったい	接待
せつぞくし	接続詞
せつぞく	接続
せっそく	節足
せっそく	拙速
せっそう	節操
せっせん	接線
せっせん	接戦
せつせつ	切々
ぜっせい	絶世
せつぜい	節税
せっせい	節制
せっせい	摂生
せっすい	節水
ぜっしょく	絶食
せつじょく	雪辱
せっしょく	節食
せっしょく	接触
ぜっしょう	絶唱
せっしょう	折衝
せっしょう	摂政
せっしょう	殺生
せつじょ	切除
せっしゅう	接収
せつじゅ	接受
せっしゅ	摂取
せっしゅ	接種
せっしやくわん	切歯扼腕
せっしゃ	拙者
せつじつ	切実
せつじ	接辞
せっし	窃視
せっし	摂氏
ぜっさん	絶賛
せっさたくま	切磋琢磨
せっさく	拙作
せっさく	切削
せっこつ	接骨
ぜっこうちょう	絶好調
ぜっこう	絶好
ぜっこう	絶交
せつごう	接合
せっこう	拙稿
せっこう	石膏
せっこう	斥候
ぜつご	絶後
せつげん	雪原
せつげん	節減
せっけん	接見
せっけん	石鹸
せっけっきゅう	赤血球
せっけいず	設計図
せっけいし	設計士
ぜっけい	絶景
せっけい	設計
ぜっく	絶句
せっく	節句
せっきん	接近
せっきょく	積極
ぜっきょう	絶叫
せっきょう	説教
せっきゃく	接客
せっき	節気
せっき	石器
せつがん	接岸
せっかん	折檻
せっかく	折角
せっかいがん	石灰岩
せつがい	雪害
せっかい	切開
せっかい	石灰
ぜっか	舌禍
ぜつえん	絶縁
せつえい	設営
ぜっ	絶
せつ	説
せつ	節
せつ	切
せっ	接
せたけ	背丈
せだい	世代
せたい	世帯
せぞく	世俗
せそう	世相
ぜせい	是正
せすじ	背筋
せじょう	世情
せじょう	施錠
せしゅう	世襲
せじ	世辞
せじ	世事
せこう	施工
ぜげん	女衒
せけん	世間
せきわけ	関脇
せきわ	積和
せきりょく	斥力
せきりょう	責了
せきり	赤痢
せきらら	赤裸々
せきら	赤裸
せきゆ	石油
せきめん	赤面
せきむ	責務
せきべつ	惜別
せきぶん	積分
せきひん	赤貧
せきひ	石碑
せきばん	石版
せきはん	赤飯
せきはい	惜敗
せきねん	積年
せきねつ	赤熱
せきにんしゃ	責任者
せきにん	責任
せきとり	関取
せきとめ	せき止め
せきどう	赤道
せきてい	石庭
せきつい	脊椎
せきたん	石炭
せきぞう	石像
せきせつ	積雪
せきずい	脊髄
せきしょく	赤色
せきじょう	席上
せきしゅつ	析出
せきじゅうじ	赤十字
せきさん	積算
せきざい	石材
せきさい	積載
せきがく	碩学
せきがえ	席替え
せきがいせん	赤外線
せきか	石化
せき	責
せき	籍
せき	積
せき	席
せき	隻
せき	寂
せき	関
せき	咳
せき	堰
せかい	世界
せおよぎ	背泳ぎ
せお	背負
せいろん	正論
せいろ	蒸篭
せいれん	精錬
せいれん	清廉
せいれつ	清冽
せいれつ	整列
せいれき	西暦
せいれい	精霊
せいれい	精励
せいれい	政令
せいりょく	精力
せいりょく	勢力
せいりょう	声量
せいりょう	清涼
せいりゅうき	整流器
せいりゅう	清流
せいりゅう	整流
せいりゃく	政略
ぜいりつ	税率
せいりつ	成立
ぜいりし	税理士
せいり	生理
せいり	整理
せいらい	生来
せいよく	性欲
せいよう	静養
せいゆう	声優
せいゆ	製油
せいやく	誓約
せいやく	製薬
せいやく	成約
せいやく	制約
せいもん	正門
せいめん	製麺
せいめい	声明
せいめい	生命
せいめい	清明
せいめい	姓名
ぜいむしょ	税務署
ぜいむ	税務
せいみつ	精密
せいまい	精米
せいほん	製本
せいほうけい	正方形
ぜいほう	税法
せいぼう	声望
せいぼう	制帽
せいほう	西方
せいほう	製法
せいほう	正方
せいぼ	生母
せいぼ	歳暮
せいべつ	性別
せいへき	性癖
せいぶん	成分
せいふん	製粉
せいぶつ	静物
せいぶつ	生物
せいふく	征服
せいふく	制服
せいぶ	西部
せいぶ	西武
せいぶ	声部
せいふ	正負
せいふ	政府
せいひん	製品
せいひん	清貧
せいひょう	製氷
せいひつ	静謐
せいび	整備
せいひ	正否
せいひ	成否
せいはんたい	正反対
せいはん	製版
せいばつ	征伐
せいはく	精白
せいばい	成敗
せいは	制覇
せいのう	性能
せいねんがっぴ	生年月日
せいねん	青年
せいねん	成年
ぜいにく	贅肉
ぜいにく	ぜい肉
せいにく	精肉
せいなる	聖なる
せいとん	整頓
せいどく	精読
せいどうき	青銅器
せいどう	青銅
せいどう	聖堂
せいどう	制動
せいとう	製糖
せいとう	正統
せいとう	正答
せいとう	正当
せいとう	政党
せいど	精度
せいど	制度
せいと	生徒
せいでんき	静電気
せいてん	聖典
せいてん	盛典
せいてん	晴天
せいてつ	製鉄
せいてき	静的
せいてき	政敵
せいてき	性的
せいてい	制定
せいつう	精通
せいちょう	静聴
せいちょう	生長
せいちょう	清澄
せいちょう	正調
せいちょう	整調
せいちょう	成長
せいちゅう	成虫
せいちゃ	製茶
せいち	聖地
せいち	精緻
せいち	生地
せいち	整地
ぜいたく	贅沢
せいたかくちゅう	正多角柱
せいたかくけい	正多角形
せいだい	盛大
せいたい	声帯
せいたい	生態
せいたい	生体
せいぞん	生存
せいぞろい	勢ぞろい
せいそく	生息
せいそく	棲息
せいぞう	製造
せいそう	盛装
せいそう	清掃
せいそう	正装
せいそう	政争
せいそ	清楚
せいぜん	生前
せいぜん	整然
せいせん	精選
せいせん	生鮮
せいせつ	正接
せいせき	成績
せいせいどうどう	正々堂々
ぜいせい	税制
せいせい	精製
せいせい	生成
せいせい	清々
せいすう	正数
せいすう	整数
せいすい	聖水
せいすい	盛衰
せいず	製図
せいず	星図
せいしんか	精神科
せいじん	成人
せいしん	誠心
せいしん	精神
せいしん	星辰
せいしょく	聖職
せいしょく	生色
せいしょく	生殖
せいしょうねん	青少年
せいじょうき	星条旗
せいじょう	清浄
せいじょう	正常
せいじょう	政情
せいしょう	斉唱
せいしょう	清祥
せいしょう	清勝
せいじょ	整除
せいしょ	聖書
せいしょ	清書
せいじゅん	清純
せいしゅん	青春
せいじゅく	成熟
ぜいしゅう	税収
せいしゅ	清酒
ぜいじゃく	脆弱
せいじゃく	静寂
せいしゃいん	正社員
せいじゃ	聖者
せいじゃ	正邪
せいじつ	誠実
せいしつ	声質
せいしつ	性質
せいしき	正式
せいしき	制式
せいじか	政治家
せいじ	青磁
せいじ	政治
せいし	静止
せいし	製紙
せいし	精子
せいし	生死
せいし	正視
せいし	制止
せいさんち	生産地
せいさんだか	生産高
せいさん	精算
せいさん	生産
せいさん	清算
せいさん	正餐
せいさん	成算
せいさん	凄惨
せいさく	製作
せいさく	政策
せいさく	制作
せいざいかい	政財界
せいざい	製材
せいさい	精細
せいさい	正妻
せいさい	制裁
せいざ	正座
せいざ	星座
せいさ	精査
せいさ	性差
せいこん	精魂
せいこん	成婚
ぜいこみ	税込み
せいこつ	整骨
せいこく	正鵠
せいこうほう	正攻法
せいこううどく	晴耕雨読
せいごう	整合
せいこう	製鋼
せいこう	精鋼
せいこう	精巧
せいこう	生硬
せいこう	成功
せいこう	性交
せいご	生後
せいご	正誤
せいご	成語
ぜいげん	贅言
ぜいげん	税源
せいげん	正弦
せいげん	制限
せいけん	政見
せいけん	政権
せいけつ	清潔
せいけい	生計
せいけい	整形
せいけい	成形
せいぐん	西軍
せいくう	制空
ぜいきん	税金
せいきん	精勤
せいきょく	政局
せいぎょう	盛業
せいぎょう	成業
せいきょう	盛況
せいきょう	生協
せいぎょ	制御
せいきょ	逝去
せいきょ	盛挙
せいきゅう	請求
せいきゅう	性急
せいきまつ	世紀末
せいきか	正規化
せいぎ	正義
せいき	精気
せいき	精機
せいき	生起
せいき	生気
せいき	正規
せいき	性器
せいき	世紀
ぜいかん	税関
せいがん	請願
せいかん	静観
せいかん	精悍
せいかん	生還
せいかつ	生活
ぜいがく	税額
せいがく	声楽
せいかく	正確
せいかく	性格
せいかい	精解
せいかい	盛会
せいかい	正解
せいかい	政界
せいか	青果
せいか	製菓
せいか	聖火
せいか	聖歌
せいか	精華
せいか	盛夏
せいか	生花
せいか	生家
せいか	正課
せいか	正価
せいか	成果
せいおん	静穏
せいおん	清音
せいえん	製塩
せいえん	声援
せいえき	精液
せいえい	精鋭
せいえい	清栄
せいうん	青雲
せいうん	盛運
せいうん	星雲
せいいん	正員
せいいん	成因
せいいん	成員
せいいっぱい	精一杯
せいいっぱい	精いっぱい
せいいつ	斉一
せいいく	生育
せいいく	成育
せいい	誠意
せいあん	成案
せいあつ	制圧
ぜい	税
せい	製
せい	精
せい	生
せい	正
せい	性
せい	征
せい	姓
せい	制
せい	所為
ぜ	是
せ	背
せ	瀬
せ	競
すんわ	寸話
すんぽう	寸法
すんぶん	寸分
すんぴょう	寸評
すんてつ	寸鉄
すんだん	寸断
すんぜん	寸前
すんじ	寸時
すんし	寸志
すんげき	寸劇
すんか	寸暇
すん	寸
すわりこ	座り込
すわ	据わ
すわ	座
ずろく	図録
すれちが	すれ違
ずれこ	ずれ込
すれあ	擦れ合
するめ	鯣
するど	鋭
すりむ	擦りむ
すりへら	すり減ら
すりへ	すり減
すりばち	擂鉢
すりばち	すり鉢
すりぬけ	すり抜け
すりこ	擦り込
すりきれ	擦り切れ
すりかえ	すり替え
すり	摺
すもも	李
すもう	相撲
ずめん	図面
すみやか	速やか
すみび	炭火
すみなれ	住み慣れ
すみつ	住み着
すみずみ	隅々
すみこ	住み込
すみか	住処
すみえ	墨絵
すみ	墨
すみ	炭
すみ	済
すみ	隅
すみ	角
すまい	住まい
すまい	住い
すま	澄ま
すま	住ま
すま	済ま
ずぼし	図星
ずほう	図法
すべりだ	滑り出
すべりこ	滑り込
すべりおち	滑り落ち
すべて	全て
すべ	統べ
すべ	術
すべ	滑
すぶた	酢豚
ずふ	図譜
ずひょう	図表
すばる	昴
すばらし	素晴らし
すばや	素早
ずばぬけ	ずば抜け
すはだ	素肌
すばこ	巣箱
すのもの	酢の物
ずのう	頭脳
すね	拗ね
すなわち	即ち
すなやま	砂山
すなはま	砂浜
すなば	砂場
すなどけい	砂時計
すなじ	砂地
すながわ	砂川
すなお	素直
すな	砂
すどおり	素通り
すどおし	素通し
すてばち	捨て鉢
すでに	既に
すてさ	捨て去
すてき	素敵
すで	素手
すて	捨て
ずつう	頭痛
すだれ	簾
すたれ	廃れ
すだ	巣立
すた	廃
すその	裾野
ずぞう	図像
すそ	裾
すずり	硯
すずらん	鈴蘭
すずめばち	雀蜂
すずめ	雀
すすめ	薦め
すすめ	進め
すすめ	奨め
すすめ	勧め
すすみだ	進み出
すずし	涼し
すずき	鱸
すすき	薄
すずかぜ	涼風
すず	鈴
すず	涼
すず	錫
すす	煤
すす	濯
すす	進
すじわる	筋悪
ずじょう	頭上
ずじょう	図上
すじょう	素性
すじみち	筋道
ずしき	図式
すじがき	筋書き
すじがき	筋書
ずし	逗子
ずし	図示
ずし	寿司
すじ	筋
すし	鮨
すし	寿司
ずざん	杜撰
すさまじさ	凄まじさ
すさまじ	凄まじ
すこやか	健やか
すこしも	少しも
すこし	少し
ずこう	図工
すご	凄
すご	過ご
ずけい	図形
すけ	透け
すぐれ	優れ
すくなくとも	少なくとも
すくなからず	少なからず
すくな	少な
すくいだ	救い出
すく	巣食
すく	救
すく	掬
すぎやま	杉山
すきま	隙間
すきま	すき間
すきばら	空腹
すきとお	透き通
すきっぱら	空きっ腹
すきずき	好きずき
すぎさ	過ぎ去
すぎ	杉
すぎ	過ぎ
すき	犁
すき	鋤
すき	好き
すき	隙
すかんぴん	素寒貧
ずかん	図鑑
ずがら	図柄
すがた	姿
すがお	素顔
ずがいこつ	頭蓋骨
ずかい	図解
ずが	図画
すか	透か
すえひろ	末広
すえなが	末長
すえつけ	据え付け
すえきち	末吉
すえお	据え置
すえ	末
すえ	陶
すえ	据え
すうれつ	数列
すうりょう	数量
すうりかがっか	数理科学科
すうり	数理
すうよう	枢要
すうめい	数名
すうはい	崇拝
すうにん	数人
すうち	数値
すうだい	数台
すうせい	趨勢
ずうずうし	図々し
すうじつ	数日
すうじく	枢軸
すうしき	数式
すうじ	数字
すうし	数詞
すうこう	崇高
すうこ	数個
すうき	数奇
すうがく	数学
すうかい	数回
すう	数
すいろん	推論
すいろ	水路
すいりょく	水力
すいりょく	推力
すいりょう	水量
すいりょう	推量
すいりゅう	水流
すいり	推理
すいようび	水曜日
すいようえき	水溶液
すいよう	水曜
すいもん	水門
すいめん	水面
すいみん	睡眠
すいみゃく	水脈
すいま	睡魔
すいぼつ	水没
すいぼくが	水墨画
すいぼう	衰亡
すいへい	水平
ずいぶん	随分
すいぶん	水分
すいふ	水夫
ずいひつ	随筆
すいはんき	炊飯器
ずいはん	随伴
すいばん	水盤
すいばく	水爆
すいなん	水難
すいどう	水道
すいとう	水筒
すいとう	水稲
すいとう	出納
すいと	吸い取
すいでん	水田
すいてき	水滴
すいてい	水底
すいてい	推定
すいちょく	垂直
すいちゅうよくせん	水中翼船
すいちゅう	水中
すいたい	衰退
すいぞくかん	水族館
すいそく	推測
ずいそう	随想
すいぞう	膵臓
すいそう	水葬
すいそう	水槽
すいそう	吹奏
すいそ	水素
すいぜん	垂涎
すいせん	水洗
すいせん	水仙
すいせん	推薦
すいせん	垂線
すいせい	彗星
すいせい	水性
すいしん	水深
すいしん	推進
すいしん	垂心
すいじょうき	水蒸気
すいじょう	水上
すいしょう	水晶
すいしょう	推賞
すいしょう	推奨
ずいしょ	随所
すいじゅん	水準
すいじゃく	衰弱
すいしゃ	水車
すいしつ	水質
ずいじ	随時
すいじ	炊事
すいし	水死
すいさんか	水酸化
すいさん	水産
すいさん	推算
すいさつ	推察
すいさいが	水彩画
ずいこう	随行
すいこう	遂行
すいこう	推敲
すいこう	推考
すいこ	吸い込
すいげん	水源
すいけい	推計
すいぎん	水銀
すいきょう	粋狂
すいきょ	推挙
すいきゅう	水球
すいがら	吸殻
すいがい	水害
すいか	誰何
すいか	西瓜
すいか	垂下
すいおん	水温
すいえい	水泳
ずいいん	随員
ずいいち	随一
すいいき	水域
ずいい	随意
すいい	水位
すいい	推移
すいあつ	水圧
すいあげ	吸い上げ
ずい	髄
ずい	随
すい	粋
すい	水
ずあん	図案
すあし	素足
ず	頭
ず	図
す	透
す	巣
す	素
す	棲
す	摺
す	澄
す	酢
す	住
す	洲
す	州
す	擦
す	刷
す	済
す	漉
す	好
す	空
す	吸
しんわ	親和
しんわ	神話
しんろう	新郎
しんろう	心労
しんろ	進路
しんれい	心霊
じんるい	人類
しんるい	親類
しんりん	森林
じんりょく	尽力
じんりょく	人力
しんりょく	新緑
しんりょう	診療
しんりょ	神慮
しんりょ	深慮
しんりゃく	侵略
じんりきしゃ	人力車
しんり	真理
しんり	心理
しんり	審理
しんらばんしょう	森羅万象
しんらつ	辛辣
しんらい	信頼
じんよう	陣容
しんよう	信用
しんゆう	親友
しんや	深夜
じんもん	尋問
しんもん	審問
しんもつ	進物
じんめい	人命
じんめい	人名
しんめい	身命
しんめ	新芽
じんみん	人民
しんみょう	神妙
じんみゃく	人脈
しんみつ	親密
しんみ	親身
しんまい	新米
しんぽん	新本
しんぼく	親睦
しんぼく	神木
じんぼう	人望
しんぽう	新法
しんぽう	信奉
しんぼう	辛抱
しんぼう	心棒
しんぼう	信望
しんぽ	進歩
しんぺん	身辺
じんぶん	人文
しんぶん	新聞
じんぶつ	人物
しんぶつ	神仏
しんふぜん	心不全
しんぷく	振幅
しんぷう	新風
しんぷ	神父
しんぷ	新譜
しんぷ	新婦
しんぶ	深部
しんぴん	新品
しんぴょう	信憑
しんぴ	神秘
しんぴ	真否
しんび	審美
しんぱん	審判
しんぱん	侵犯
しんばん	新盤
しんはつばい	新発売
しんばし	新橋
しんぱい	心配
じんば	人馬
しんぱ	新派
しんねんかい	新年会
しんねん	新年
しんねん	信念
しんにん	新任
しんにん	信任
しんにゅうせい	新入生
しんにゅうがく	新入学
しんにゅう	進入
しんにゅう	浸入
しんにゅう	新入
しんにゅう	侵入
しんにちは	親日派
じんとく	人徳
しんとうあつ	浸透圧
じんどう	人道
じんとう	陣頭
しんどう	震動
しんどう	神童
しんどう	振動
しんとう	親等
しんとう	浸透
しんとう	新党
しんとう	心頭
しんど	震度
しんど	進度
しんでんず	心電図
しんでん	神殿
しんでん	新田
しんてん	進展
しんてん	親展
しんてん	伸展
じんてき	人的
しんてき	心的
じんてい	人定
しんてい	進呈
じんつうりき	神通力
じんつう	陣痛
しんつう	心痛
しんちんたいしゃ	新陳代謝
しんちょく	進捗
じんちょうげ	沈丁花
しんちょう	身長
しんちょう	深長
しんちょう	新調
しんちょう	慎重
しんちょう	伸長
じんちゅう	陣中
しんちゅう	進駐
しんちゅう	真鍮
しんちゅう	心中
じんちく	人畜
しんちく	新築
じんち	陣地
じんち	人知
しんち	新地
しんだん	診断
しんたくぎんこう	信託銀行
しんたく	神託
しんたく	信託
しんたいそう	新体操
しんたいせい	新体制
じんだい	甚大
じんたい	人体
しんだい	寝台
しんたい	進退
しんたい	身体
しんたい	神体
しんそつ	新卒
しんそこ	心底
じんそく	迅速
しんぞく	親族
じんぞう	腎臓
じんぞう	人造
しんぞう	心臓
しんそう	真相
しんそう	深窓
しんそう	深層
じんせん	人選
しんぜん	親善
しんぜん	神前
しんせん	震顫
しんせん	芯線
しんせん	神仙
しんせん	新鮮
しんせん	心線
しんせつ	親切
しんせつ	新雪
しんせつ	新説
しんせつ	新設
じんせき	人跡
しんせき	親戚
じんせいろん	人生論
しんせいひん	新製品
しんせいじ	新生児
じんせいかん	人生観
じんせい	人生
しんせい	神聖
しんせい	真正
しんせい	真性
しんせい	申請
しんせい	新生
しんせい	新星
しんせい	新制
しんずい	神髄
しんずい	真髄
しんずい	心髄
しんすい	進水
しんすい	浸水
しんすい	心酔
じんしん	人身
しんじん	新人
しんじん	信心
しんしん	津津
しんしん	新進
しんしん	心身
しんしょく	浸蝕
しんしょく	浸食
しんしょく	寝食
しんしょく	侵蝕
しんしょく	侵食
しんしょうひん	新商品
しんしょうしゃ	身障者
じんじょう	尋常
しんじょう	進上
しんじょう	身上
しんじょう	心情
しんじょう	信条
しんしょう	辛勝
しんしょう	心証
しんしょ	新書
しんしゅん	新春
しんしゅつ	進出
しんしゅつ	浸出
しんしゅつ	侵出
しんしゅく	伸縮
しんじゅう	心中
じんしゅ	人種
しんじゅ	真珠
しんしゅ	進取
しんしゅ	新酒
しんしゅ	新種
しんしゃく	斟酌
じんじゃ	神社
しんじゃ	信者
しんしゃ	深謝
しんしゃ	新車
しんじつ	真実
しんしつ	寝室
しんしき	新式
じんじか	人事課
じんじ	人事
しんじ	信じ
しんし	紳士
しんざん	新参
しんさん	辛酸
しんさつ	診察
しんさつ	新札
しんさく	新作
じんざい	人材
じんさい	人災
しんさい	震災
しんさ	審査
しんこん	新婚
しんこっちょう	真骨頂
じんこつ	人骨
しんこくざい	親告罪
しんこく	親告
しんこく	申告
しんこく	深刻
しんこきゅう	深呼吸
じんこう	人工
じんこう	人口
しんごう	信号
しんこう	進行
しんこう	親好
しんこう	親交
しんこう	新興
しんこう	振興
しんこう	侵攻
しんこう	信仰
じんけんひ	人件費
しんげんち	震源地
じんけん	人権
じんけん	人件
しんげん	震源
しんけん	親権
しんけん	真剣
しんけつ	心血
しんげき	進撃
しんけいつう	神経痛
しんけいしつ	神経質
しんけい	神経
しんぐん	進軍
しんくうかん	真空管
じんぐう	神宮
しんぐう	新宮
しんくう	真空
しんぐ	寝具
しんく	辛苦
しんく	真紅
しんぎん	呻吟
しんきん	親近
しんきん	心筋
しんきん	信金
しんきろく	新記録
しんきろう	蜃気楼
しんきょく	新曲
しんきょう	心境
しんきょう	信教
しんきょ	新居
しんきゅう	進級
しんきゅう	新旧
しんぎたい	心技体
しんぎじゅつ	新技術
しんぎかい	審議会
じんぎ	仁義
しんぎ	真偽
しんぎ	審議
しんき	新規
しんき	新奇
しんき	心機
しんかんせん	新幹線
しんかん	新館
しんかん	新刊
しんかぶ	新株
しんがた	新型
じんがさ	陣笠
じんかく	人格
しんがく	進学
しんがく	神学
しんがお	新顔
しんかいち	新開地
じんかいせんじゅつ	人海戦術
じんかい	塵芥
じんかい	人海
しんがい	心外
しんがい	侵害
しんかい	深海
じんか	人家
しんか	進化
しんか	臣下
しんか	真価
しんか	深化
しんおん	心音
しんおう	震央
しんえん	深遠
じんえい	陣営
しんえい	親衛
しんえい	新鋭
しんうち	真打ち
じんいん	人員
しんいり	新入り
じんい	人為
しんい	真意
しんい	深意
しんあん	新案
じんあい	塵埃
しんあい	親愛
じん	陣
じん	仁
しん	進
しん	芯
しん	真
しん	新
しん	心
しん	信
しん	伸
しわよせ	しわ寄せ
しわす	師走
しわざ	仕業
しわけ	仕訳
しわけ	仕分け
しわく	思惑
しわ	皺
じろん	持論
しろん	私論
しろん	史論
しろやま	城山
しろもの	代物
しろむく	白無垢
しろみ	白身
しろぼし	白星
しろばい	白バイ
しろっぽ	白っぽ
しろじ	白地
しろざとう	白砂糖
しろくろ	白黒
しろくま	白熊
しろくじちゅう	四六時中
しろうと	素人
しろう	屍蝋
しろ	白
しろ	城
しれん	試練
しれわた	知れ渡
じれい	辞令
じれい	事例
しれい	指令
しれい	司令
しるべ	標
しるし	印
しる	汁
しる	記
じりょく	磁力
しりょく	資力
しりょく	視力
しりょく	死力
しりょう	飼料
しりょう	資料
しりょう	試料
しりょう	死霊
しりょう	思量
しりょう	史料
しりょ	思慮
じりゅう	自流
じりゅう	時流
しりゅう	支流
しりめつれつ	支離滅裂
しりめ	後目
しりぬぐい	尻拭い
しりぬ	知り抜
しりつぼみ	尻つぼみ
じりつご	自立語
じりつ	自立
じりつ	自律
じりつ	而立
しりつ	私立
しりつ	市立
しりぞけ	退け
しりぞけ	斥け
しりぞ	退
しりごみ	尻込み
しりごみ	後込み
じりき	地力
じりき	自力
しりあい	知合い
しりあ	知り合
しり	尻
しり	私利
しらべ	調べ
しらは	白羽
しらぬい	不知火
しらたまこ	白玉粉
しらたま	白玉
しらじらし	白々し
しらさぎ	白鷺
しらこ	白子
しらけ	白け
しらくも	白癬
しらき	白木
しらかば	白樺
しらが	白髪
じらいげん	地雷原
じらい	地雷
しら	白
しら	知ら
しょんべん	小便
じょろん	序論
しょろう	初老
じょれつ	序列
しょるい	書類
じょりょく	助力
じょりゅう	女流
しょり	処理
しょよう	所要
しょよう	所用
しょゆうち	所有地
じょゆう	女優
しょゆう	所有
じょやく	助役
じょや	除夜
しょもつ	書物
しょもう	所望
しょめん	書面
じょめい	除名
じょめい	助命
しょめい	書名
しょめい	署名
しょむ	庶務
しょみん	庶民
じょまくしき	除幕式
じょまく	序幕
しょほうせん	処方箋
しょぼう	書房
しょほう	諸方
しょほう	処方
しょほ	初歩
じょぶん	序文
しょぶん	処分
しょひょう	諸表
しょひょう	書評
じょばん	序盤
しょはん	諸般
しょはん	初犯
しょはん	初版
しょばつ	処罰
じょのくち	序の口
しょねんど	初年度
しょにんきゅう	初任給
しょにち	初日
しょない	所内
しょとく	所得
じょどうし	助動詞
しょどう	書道
しょとう	諸島
しょとう	初頭
しょとう	初等
しょとう	初冬
しょてん	書店
しょてい	所定
しょて	初手
しょっぴ	しょっ引
しょっこう	職工
しょっけん	食券
しょっけん	職権
しょっくし	ショック死
しょっきり	初っ切り
しょっき	食器
しょっかん	食間
しょっかん	触感
しょっかく	触覚
じょちょう	助長
しょちょう	署長
しょちょう	所長
しょちょう	初潮
じょちゅう	女中
しょちゅう	書中
しょちゅう	暑中
しょち	処置
しょだん	初段
しょだな	書棚
しょたいめん	初対面
じょたい	除隊
しょだい	初代
しょたい	書体
しょたい	所帯
しょぞん	所存
しょぞく	所属
しょそく	初速
じょそう	除草
じょそう	女装
じょそう	助走
しょぞう	所蔵
しょそう	諸相
しょせん	緒戦
しょせん	所詮
じょせつ	除雪
じょせつ	序説
しょせつ	諸説
じょせき	除籍
しょせき	書籍
しょせいくん	処世訓
じょせい	女婿
じょせい	女声
じょせい	女性
じょせい	助成
じょせい	助勢
しょぜい	諸税
しょせい	書生
しょせい	処世
じょすうし	助数詞
しょしんしゃ	初心者
しょしん	書信
しょしん	所信
しょしん	初診
しょしん	初心
しょしん	初審
じょじょに	徐々に
じょじょう	叙情
じょしょう	序章
しょじょう	書状
しょしょう	書証
しょじょ	処女
しょしょ	諸処
しょしょ	処暑
しょじゅん	初旬
しょしゅん	初春
じょじゅつ	叙述
しょしゅつ	初出
しょしゅう	所収
しょしゅう	初秋
じょしゅ	助手
しょしゃ	書写
じょしだい	女子大
しょしき	諸式
しょしき	書式
じょじ	女児
じょじ	叙事
じょし	女子
じょし	女史
じょし	助詞
しょじ	諸事
しょじ	所持
しょし	諸氏
しょし	初志
じょさんぷ	助産婦
じょざん	除算
じょさん	除算
しょさん	所産
じょさいな	如才な
しょざいな	所在な
しょざいち	所在地
じょさい	如才
しょざい	所在
しょさい	書斎
しょさい	所載
しょさ	所作
しょこん	初婚
しょこく	諸国
じょこう	除光
じょこう	徐行
しょこう	初校
しょこ	書庫
じょげん	助言
しょげん	諸元
しょげん	緒言
しょけん	書見
しょけん	所見
しょけん	初見
じょけつ	女傑
しょけい	諸兄
しょけい	処刑
じょくん	叙勲
しょくん	諸君
しょくれき	職歴
しょくりん	植林
しょくりょうひん	食料品
しょくりょうなん	食糧難
しょくりょう	食糧
しょくりょう	食料
しょくよく	食欲
しょくよう	食用
しょくもつ	食物
しょくもく	属目
しょくもう	植毛
しょくむ	職務
しょくみんち	植民地
しょくぼう	嘱望
しょくほう	触法
しょくぶん	職分
しょくぶつ	植物
しょくひん	食品
しょくひ	食費
しょくはつ	触発
しょくばい	触媒
しょくば	職場
しょくのう	職能
しょくにん	職人
しょくにく	食肉
しょくどう	食道
しょくどう	食堂
しょくつう	食通
しょくちゅうどく	食中毒
しょくち	諸口
しょくたく	食卓
しょくたく	嘱託
しょくだい	燭台
しょくぜん	食膳
しょくぜん	食前
しょくせき	職責
しょくせいかつ	食生活
しょくせい	職制
しょくせい	植生
しょくしん	触診
しょくしょう	食傷
しょくしょう	職掌
しょくじゅう	職住
しょくじゅ	植樹
しょくしゅ	触手
しょくしゅ	職種
しょくじ	食事
しょくじ	植字
しょくし	食指
しょくご	食後
しょくぎょう	職業
しょくえん	食塩
しょぐう	処遇
しょくいん	職員
しょくい	職位
しょくあん	職安
しよく	私欲
しょく	属
しょく	食
しょく	職
しょく	嘱
しょぎょうむじょう	諸行無常
じょきょうじゅ	助教授
しょぎょう	諸行
しょぎょう	所業
じょきょ	除去
しょきゅう	初級
しょきちょう	書記長
しょき	書記
しょき	所期
しょき	初期
しょかん	書簡
しょかん	所管
しょかん	所感
しょかつ	所轄
じょがくせい	女学生
じょがい	除外
しょがい	所外
しょかい	初回
しょかい	初会
しょが	書画
しょか	書架
しょか	初夏
じょおう	女王
じょえん	助演
しょえん	初演
しょうわる	性悪
しょうわくせい	小惑星
しょうわ	唱和
しょうろん	詳論
しょうろく	抄録
じょうれん	常連
じょうれい	条例
じょうれい	常例
しょうれい	省令
しょうれい	奨励
じょうるり	浄瑠璃
じょうりょくじゅ	常緑樹
じょうりょく	常緑
しょうりょく	省力
しょうりょう	渉猟
しょうりょう	少量
しょうりょう	小量
しょうりょ	焦慮
じょうりゅう	蒸留
じょうりゅう	上流
しょうりゃく	省略
じょうりく	上陸
じょうり	条理
しょうり	勝利
じょうらん	擾乱
じょうらん	上覧
しょうらん	笑覧
しょうらん	照覧
しょうらい	招来
しょうらい	将来
じょうよく	情欲
しょうようじゅりん	照葉樹林
じょうようしゃ	乗用車
じょうよう	常用
じょうよう	乗用
しょうよう	慫慂
しょうよう	商用
じょうよ	譲与
じょうよ	剰余
しょうよ	賞与
しょうゆ	醤油
じょうやど	定宿
じょうやど	常宿
じょうやく	条約
しょうやく	生薬
しょうやく	抄訳
しょうや	庄屋
じょうもん	縄文
しょうもん	証文
しょうもう	消耗
しょうめん	正面
しょうめつ	消滅
しょうめい	正銘
しょうめい	証明
しょうめい	照明
じょうむ	常務
じょうむ	乗務
じょうみん	常民
じょうみゃく	静脈
しょうみ	正味
しょうみ	賞味
しょうまん	小満
しょうほん	抄本
しょうぼうしょ	消防署
じょうほう	情報
じょうほう	上方
しょうぼう	焼亡
しょうぼう	消防
しょうほう	商法
じょうほ	譲歩
しょうべん	小便
しょうへん	掌編
しょうへん	掌篇
じょうへき	城壁
しょうへき	障壁
しょうへい	招聘
しょうへい	将兵
じょうぶん	条文
しょうぶん	性分
じょうぶつ	成仏
しょうふだ	正札
しょうふく	承伏
しょうふく	妾腹
じょうぶ	丈夫
じょうぶ	上部
しょうぶ	勝負
しょうふ	娼婦
じょうひん	上品
しょうひん	賞品
しょうひん	商品
しょうびょう	傷病
しょうひょう	商標
しょうひぜい	消費税
しょうひしゃ	消費者
じょうび	常備
しょうび	賞美
しょうび	焦眉
しょうひ	消費
じょうはんしん	上半身
しょうばん	相伴
じょうはつ	蒸発
しょうばつ	賞罰
しょうばい	商売
しょうはい	賞杯
しょうはい	勝敗
じょうば	乗馬
しょうは	小破
じょうのう	上納
しょうのう	笑納
しょうのう	樟脳
しょうねんば	正念場
じょうねん	情念
しょうねん	少年
じょうねつ	情熱
しょうねつ	焦熱
しょうね	性根
じょうにん	常任
しょうにん	証人
しょうにん	昇任
しょうにん	承認
しょうにん	小人
しょうにん	商人
しょうにゅうどう	鍾乳洞
しょうに	小児
しょうなごん	少納言
じょうない	場内
じょうない	城内
しょうない	渉内
しょうとつ	衝突
しょうどく	消毒
じょうとうく	常套句
じょうとう	常套
じょうとう	上等
しょうどう	衝動
しょうとう	消灯
じょうど	浄土
じょうと	譲渡
しょうど	照度
しょうど	焦土
じょうてんき	上天気
しょうてん	衝天
しょうてん	焦点
しょうてん	昇天
しょうてん	商店
じょうでき	上出来
しょうちん	消沈
じょうちょう	冗長
しょうちょう	象徴
しょうちょう	省庁
しょうちょう	消長
しょうちょう	小腸
じょうちょ	情緒
しょうちょ	小著
じょうちゅう	常駐
しょうちゅう	焼酎
しょうちゅう	掌中
じょうちゃく	蒸着
しょうちくばい	松竹梅
じょうち	常置
じょうち	上智
しょうち	招致
しょうち	承知
じょうだん	冗談
じょうだん	上段
じょうたん	上端
しょうだん	商談
しょうたん	賞嘆
しょうだて	章立て
じょうたつ	上達
しょうだく	承諾
しょうたく	妾宅
じょうたい	状態
じょうたい	常態
しょうたい	正体
しょうたい	招待
しょうたい	小隊
しょうぞく	装束
しょうそく	消息
じょうぞう	醸造
じょうそう	情操
じょうそう	上層
しょうぞう	肖像
しょうそう	焦燥
しょうそう	尚早
じょうそ	上訴
しょうそ	勝訴
じょうせん	乗船
しょうせん	商船
しょうせつか	小説家
じょうぜつ	饒舌
じょうせつ	常設
しょうせつ	詳説
しょうせつ	章節
しょうせつ	小雪
しょうせつ	小説
しょうせつ	小節
じょうせき	定石
じょうせき	上席
しょうせき	硝石
じょうせい	醸成
じょうせい	状勢
じょうせい	情勢
しょうせい	招請
しょうせい	小生
じょうすう	定数
じょうすう	常数
しょうすう	少数
しょうすう	小数
じょうすいどう	上水道
じょうすい	浄水
じょうすい	上水
しょうすい	憔悴
しょうすい	小水
じょうず	上手
じょうしんこ	上新粉
じょうじん	常人
じょうしん	上申
しょうじん	精進
しょうしん	正真
しょうしん	焦心
しょうしん	焼身
しょうしん	昇進
しょうしん	小心
しょうしん	傷心
じょうしょく	常食
しょうしょく	少食
しょうしょく	小食
しょうしょく	小職
じょうじょう	嫋々
じょうじょう	情状
じょうじょう	上場
じょうじょう	上乗
じょうじょう	上々
じょうしょう	上昇
しょうじょう	賞状
しょうじょう	症状
しょうしょう	少々
しょうしょう	少将
じょうじょ	乗除
じょうしょ	情緒
しょうじょ	少女
しようしょ	仕様書
しょうしょ	証書
しょうしょ	小暑
じょうじゅん	上旬
しょうじゅん	照準
じょうじゅつ	上述
しょうじゅつ	詳述
しょうしゅつ	抄出
しょうしゅくしゃく	小縮尺
しょうじゅう	小銃
しょうしゅう	消臭
しょうしゅう	招集
しょうしゅう	召集
じょうじゅ	成就
じょうしゅ	城主
じょうしゃ	乗車
しょうじゃ	精舎
しょうしゃ	瀟洒
しょうしゃ	照射
しょうしゃ	抄写
しょうしゃ	小社
しょうしゃ	商社
しょうしゃ	勝者
じょうしつ	上質
しょうしつ	焼失
しょうしつ	消失
じょうしき	常識
しょうじき	正直
じょうじ	情事
じょうじ	常時
じょうし	情死
じょうし	上司
じょうし	上梓
しょうじ	生じ
しょうじ	障子
しょうじ	商事
しょうし	証紙
しょうし	笑止
しょうし	焼死
じょうざん	乗算
じょうさん	蒸散
じょうさん	乗算
しょうさん	賞賛
しょうさん	称賛
しょうさん	硝酸
しょうさん	消散
しょうさん	勝算
じょうざい	錠剤
じょうさい	城砦
しょうさい	詳細
しょうさい	商才
しょうさ	照査
しょうさ	少佐
しょうさ	小差
しょうこん	商魂
じょうこく	上告
しょうごく	生国
しょうこく	生国
しょうこく	小国
しょうこうねつ	猩紅熱
しょうこうぐん	症候群
じょうこう	条項
じょうこう	情工
じょうこう	乗降
じょうこう	上皇
しょうごう	称号
しょうごう	照合
しょうごう	商号
しょうこう	症候
しょうこう	焼香
しょうこう	消光
しょうこう	昇降
しょうこう	小康
しょうこう	将校
しょうこう	商工
じょうご	漏斗
じょうご	上戸
じょうこ	上古
しょうご	正午
しょうこ	証拠
じょうげん	上限
じょうげん	上弦
じょうけん	条件
しょうげん	証言
しょうけん	證券
しょうけん	証券
しょうけつ	焼結
しょうげきは	衝撃波
しょうげき	衝撃
じょうけい	情景
しょうけい	憧憬
しょうけい	象形
しょうけい	小計
じょうげ	上下
しょうぐん	将軍
じょうくう	上空
じょうきん	常勤
しょうきん	賞金
しょうきん	償金
しょうきょく	消極
じょうきょう	状況
じょうきょう	上京
しょうぎょう	商業
しょうきょ	消去
じょうきゅう	上級
しょうきゅう	昇給
しょうきゅう	昇級
じょうきゃく	乗客
しょうきゃく	焼却
しょうきゃく	消却
しょうきゃく	償却
しょうきぼ	小規模
じょうぎ	定規
じょうき	蒸気
じょうき	常規
じょうき	上記
じょうき	上気
しょうぎ	将棋
しょうき	正気
じょうかん	情感
じょうかん	上官
じょうかん	上巻
しょうかん	小寒
しょうかん	将官
しょうかん	召喚
しょうかん	償還
じょうかまち	城下町
しょうがっこう	小学校
しょうがつ	正月
じょうかそう	浄化槽
しょうがくぶ	商学部
しょうがくせい	小学生
しょうがくせい	奨学生
しょうがく	少額
しょうがく	小額
しょうがく	小学
しょうがく	奨学
しょうかく	昇格
じょうがい	場外
じょうかい	上界
しょうがい	生涯
しょうがい	障碍
しょうがい	障害
しょうがい	渉外
しょうがい	傷害
しょうかい	詳解
しょうかい	紹介
しょうかい	照会
しょうかい	商会
じょうか	浄化
しょうが	生姜
しょうか	消火
しょうか	消化
じょうおん	常温
しょうおん	消音
じょうおう	女王
しょうおう	照応
じょうえん	上演
しょうえん	招宴
しょうえん	小宴
じょうえい	上映
じょういん	乗員
じょういん	上院
しょういん	勝因
じょうい	譲位
じょうい	上位
しょうい	小異
しょうあく	掌握
じょうあい	情愛
じよう	滋養
じょう	錠
じょう	状
じょう	条
じょう	情
じょう	嬢
じょう	場
じょう	乗
じょう	上
しよう	試用
しよう	私用
しよう	止揚
しよう	使用
しよう	仕様
しょう	生
しょう	性
しょう	賞
しょう	証
しょう	章
しょう	称
しょう	省
しょう	招
しょう	小
しょう	将
しょう	升
しょいん	書院
しょいん	署員
しょいん	所員
じょい	女医
しょい	所為
しょあく	諸悪
じょ	除
じょ	恕
じょ	序
じょ	叙
しょ	書
しょ	署
しょ	所
しょ	処
じゅんろ	順路
じゅんれい	巡礼
じゅんりょう	順良
じゅんりょう	純良
じゅんり	純利
じゅんようかん	巡洋艦
じゅんよう	準用
じゅんまい	純米
じゅんぼく	純朴
じゅんぽう	順法
じゅんぽう	遵法
しゅんべつ	峻別
しゅんぶん	春分
じゅんふどう	順不同
じゅんぷう	順風
しゅんびん	俊敏
じゅんびきん	準備金
じゅんび	準備
じゅんばん	順番
しゅんぱつりょく	瞬発力
じゅんぱく	純白
じゅんのう	順応
じゅんとう	順当
しゅんとう	春闘
じゅんど	純度
じゅんちょう	順調
じゅんち	馴致
しゅんだん	春暖
じゅんたく	潤沢
じゅんたいじょし	準体助詞
じゅんたいげんじょし	準体言助詞
しゅんそく	駿足
しゅんそく	俊足
じゅんぞう	純増
じゅんせつ	順接
しゅんせつ	浚渫
しゅんせつ	春雪
じゅんせいてき	準静的
じゅんせい	純正
じゅんすい	純粋
じゅんしん	純真
じゅんしょく	純色
じゅんしょく	殉職
じゅんじょう	純情
じゅんじょ	順序
じゅんじゅんけっしょう	準々決勝
じゅんじゅん	諄々
じゅんじゅん	順々
しゅんじゅん	逡巡
しゅんじゅう	春秋
じゅんしゅ	遵守
じゅんじ	順次
じゅんし	巡視
じゅんし	殉死
しゅんじ	瞬時
じゅんさつ	巡察
じゅんさい	蓴菜
しゅんさい	俊才
じゅんさ	巡査
じゅんこう	巡行
じゅんこう	巡航
しゅんこう	竣工
じゅんけっしょう	準決勝
じゅんけつ	純血
じゅんけつ	純潔
じゅんぐり	順繰り
じゅんきん	純金
じゅんぎょう	巡業
じゅんきょ	準拠
しゅんきょ	峻拒
しゅんき	春季
じゅんかん	循環
じゅんかん	准看
しゅんかん	瞬間
じゅんかつゆ	潤滑油
じゅんかつ	潤滑
しゅんかしゅうとう	春夏秋冬
じゅんかいせき	順解析
じゅんかい	巡回
じゅんか	順化
じゅんか	純化
じゅんえん	順延
じゅんえん	巡演
じゅんえき	純益
しゅんえい	俊英
じゅんいつ	純一
じゅんい	順位
じゅんい	準尉
じゅんあい	純愛
じゅん	順
じゅん	純
じゅん	潤
じゅん	準
じゅん	淳
じゅん	殉
じゅん	准
しゅん	旬
じゅわき	受話器
しゅわ	手話
しゅろ	棕櫚
じゅれい	樹齢
しゅるい	種類
しゅりょく	主力
じゅりょうしょう	受領証
じゅりょう	受領
しゅりょう	首領
しゅりょう	狩猟
しゅりゅう	主流
じゅりつ	樹立
じゅり	受理
しゅらん	酒乱
しゅら	修羅
しゅよく	主翼
じゅよう	需要
じゅよう	受容
しゅよう	主要
じゅよ	授与
しゅやく	主役
じゅもん	呪文
じゅもく	樹木
しゅもく	種目
しゅむ	主務
じゅみょう	寿命
しゅみ	趣味
しゅぼう	首謀
しゅほう	手法
しゅほう	主峰
しゅほ	酒保
しゅべつ	種別
じゅふん	受粉
しゅぶん	主文
しゅふ	首府
しゅふ	主婦
しゅふ	主夫
しゅひん	主賓
じゅひょう	樹氷
しゅひつ	主筆
じゅひ	樹皮
しゅび	首尾
しゅび	守備
しゅひ	種皮
しゅひ	守秘
しゅはん	首班
しゅはん	主犯
じゅのう	受納
しゅのう	首脳
しゅにん	主任
じゅにゅう	授乳
じゅなん	受難
しゅとして	主として
しゅとけん	首都圏
しゅとく	取得
じゅどうたい	受動態
じゅどう	受動
しゅどう	手動
しゅどう	主導
しゅとう	種痘
しゅと	首都
しゅつるい	出塁
しゅつりょく	出力
しゅつりょう	出猟
しゅつりょう	出漁
しゅつらい	出来
しゅっぽん	出奔
しゅつぼつ	出没
しゅっぴん	出品
しゅっぴ	出費
しゅっぱん	出版
しゅっぱん	出帆
しゅっぱつ	出発
しゅつば	出馬
しゅつにゅうこく	出入国
しゅつにゅう	出入
しゅつどう	出動
しゅっとう	出頭
しゅってん	出店
しゅってん	出展
しゅってん	出典
しゅっちょう	出超
しゅっちょう	出張
しゅつだい	出題
しゅったい	出来
しゅっそう	出走
しゅっせきしゃ	出席者
しゅっせき	出席
しゅっせい	出生
しゅっせい	出征
しゅっせ	出世
しゅっすい	出水
しゅつじん	出陣
しゅっしん	出身
しゅっしょく	出色
しゅつじょう	出場
しゅっしょう	出生
しゅっしょ	出所
しゅっしょ	出処
しゅっしゃ	出社
しゅつじ	出自
しゅっし	出資
しゅっさん	出産
しゅつごく	出獄
しゅっこく	出国
しゅっこう	出航
しゅっこう	出稿
しゅっこう	出向
じゅつご	述語
じゅつご	術語
しゅっこ	出庫
しゅつげん	出現
しゅっけつ	出血
しゅっけつ	出欠
しゅつげき	出撃
しゅっきん	出金
しゅっきん	出勤
しゅつがん	出願
しゅっかん	出棺
じゅっかい	述懐
しゅっか	出荷
しゅっか	出火
しゅつえん	出演
じゅつ	術
しゅつ	出
しゅちょう	首長
しゅちょう	主潮
しゅちょう	主張
じゅちゅう	受注
しゅちゅう	手中
しゅちにくりん	酒池肉林
しゅだん	手段
じゅだく	受諾
じゅたく	受託
じゅたい	受胎
しゅだい	主題
しゅたい	主体
しゅぞく	種族
じゅぞう	受像
しゅぞう	酒造
しゅせきさん	酒石酸
しゅせき	首席
しゅせき	主席
しゅぜいほう	酒税法
じゅせい	授精
じゅせい	受精
しゅせい	守勢
じゅすい	入水
しゅすい	取水
じゅず	数珠
しゅじんこう	主人公
じゅしん	受診
じゅしん	受信
しゅじん	主人
しゅしん	主審
しゅしょく	主食
じゅしょう	授賞
じゅしょう	受賞
しゅじょう	衆生
しゅしょう	首相
しゅしょう	殊勝
しゅしょう	主将
しゅしょう	主唱
じゅじゅつ	呪術
しゅじゅつ	手術
しゅじゅつ	主述
しゅじゅう	主従
じゅじゅ	授受
しゅじゅ	種々
しゅしゃせんたく	取捨選択
しゅしゃ	取捨
しゅじく	主軸
しゅじい	主治医
じゅし	樹脂
しゅじ	主辞
しゅじ	主事
しゅし	趣旨
しゅし	種子
しゅし	主旨
じゅさん	授産
しゅざん	珠算
しゅさん	主餐
しゅざい	取材
しゅさい	主菜
しゅさい	主宰
しゅさい	主催
しゅさ	主査
しゅごしん	守護神
じゅこう	受講
しゅこう	酒肴
しゅこう	趣向
しゅご	守護
しゅご	主語
じゅけんせい	受験生
じゅけん	受験
じゅけん	受検
しゅけん	主権
じゅけい	受刑
しゅげい	手芸
しゅけい	主計
しゅくん	殊勲
しゅくん	主君
じゅくれん	熟練
じゅくりょ	熟慮
しゅくやく	縮約
しゅくめい	宿命
しゅくぼう	宿望
しゅくほう	祝砲
しゅくふく	祝福
しゅくはく	宿泊
しゅくはい	祝杯
しゅくば	宿場
じゅくねん	熟年
じゅくどく	熟読
しゅくでん	祝電
しゅくてん	祝典
しゅくてき	宿敵
しゅくちょく	宿直
じゅくち	熟知
じゅくたつ	熟達
しゅくだい	宿題
しゅくたい	縮退
しゅくぜん	粛然
じゅくせい	熟成
しゅくせい	粛清
しゅくせい	粛正
じゅくすい	熟睡
しゅくず	縮図
しゅくしょう	縮小
しゅくしょう	祝勝
しゅくじょ	淑女
しゅくしゅく	粛々
しゅくしゃく	縮尺
しゅくしゃ	縮写
しゅくしゃ	宿舎
しゅくじつ	祝日
じゅくじくん	熟字訓
じゅくし	熟柿
しゅくじ	祝辞
しゅくさつ	縮刷
じゅくこう	熟考
じゅくご	熟語
しゅくぎ	祝儀
しゅくがん	宿願
しゅくが	祝賀
しゅくえん	祝宴
しゅくい	祝意
じゅく	熟
じゅく	塾
じゅく	宿
しゅく	祝
しゅく	宿
じゅぎょう	授業
しゅぎょう	修行
しゅきゅうは	守旧派
じゅきゅう	需給
じゅきゅう	受給
しゅぎ	主義
しゅき	手記
しゅがん	主眼
しゅかん	主観
しゅかん	主幹
しゅかく	主格
じゅかい	樹海
しゅかい	主魁
しゅえん	主演
しゅえい	守衛
しゅうわい	収賄
しゅうろん	修論
しゅうろく	集録
しゅうろく	収録
しゅうろう	就労
しゅうれん	修練
しゅうれん	収斂
じゅうれつ	縦列
しゅうれい	秋冷
じゅうりん	蹂躙
しゅうりん	秋霖
じゅうりょく	重力
じゅうりょうぜい	従量税
しゅうりょうご	終了後
じゅうりょうあげ	重量挙げ
じゅうりょう	重量
しゅうりょう	終了
しゅうりょう	修了
しゅうりょう	収量
しゅうり	修理
じゅうらん	縦覧
しゅうらく	集落
じゅうらい	従来
しゅうらい	襲来
じゅうようし	重要視
じゅうよう	重要
じゅうよう	充用
しゅうよう	修養
しゅうよう	収用
しゅうよう	収容
しゅうゆう	周遊
じゅうゆ	重油
じゅうやく	重役
しゅうやく	集約
しゅうや	終夜
じゅうもんじ	十文字
しゅうもく	衆目
じゅうもう	絨毛
じゅうめん	渋面
しゅうめい	襲名
じゅうみんぜい	住民税
じゅうみんか	住民課
じゅうみん	住民
しゅうみん	就眠
じゅうまん	充満
しゅうまつ	週末
しゅうまつ	終末
しゅうまく	終幕
しゅうまい	焼売
じゅうぼく	従僕
じゅうほう	銃砲
しゅうぼう	醜貌
しゅうぼう	衆望
しゅうほう	週報
しゅうへん	周辺
しゅうへき	習癖
じゅうぶん	十分
じゅうぶん	充分
しゅうぶん	醜聞
しゅうぶん	秋分
じゅうふく	重複
しゅうふく	修復
じゅうびょう	重病
じゅうはん	重版
しゅうばん	終盤
じゅうばつ	重罰
しゅうばつ	秀抜
しゅうはすう	周波数
しゅうばす	終バス
じゅうばこ	重箱
しゅうはい	集配
しゅうは	秋波
しゅうは	宗派
しゅうは	周波
しゅうのう	収納
しゅうねん	周年
しゅうねん	執念
じゅうにん	住人
しゅうにん	就任
しゅうにゅう	収入
じゅうにしちょう	十二指腸
じゅうにし	十二支
じゅうなん	柔軟
しゅうとめ	姑
しゅうとく	習得
しゅうとく	拾得
しゅうとく	修得
しゅうとく	収得
じゅうどう	柔道
じゅうとう	充当
しゅうどう	修道
しゅうとう	周到
しゅうと	姑
じゅうでん	充電
じゅうてん	重点
じゅうてん	充填
しゅうでん	終電
しゅうてん	終点
しゅうちょう	酋長
しゅうちゅう	集中
しゅうちゃく	終着
しゅうちゃく	執着
しゅうちく	修築
しゆうち	私有地
しゅうち	羞恥
しゅうち	習知
しゅうち	周知
じゅうだん	銃弾
じゅうだん	縦断
じゅうたん	絨毯
しゅうだん	集団
しゅうたん	終端
しゅうたん	愁嘆
じゅうたくち	住宅地
じゅうたくがい	住宅街
じゅうたく	住宅
しゅうたいせい	集大成
じゅうだい	重大
じゅうたい	重体
じゅうたい	渋滞
しゅうたい	醜態
じゅうぞく	従属
じゅうそく	充足
しゅうぞく	習俗
しゅうそく	集束
しゅうそく	終息
しゅうそく	収束
じゅうそう	重曹
じゅうそう	重奏
じゅうそう	縦走
しゅうそ	臭素
しゅうそ	愁訴
じゅうぜん	従前
じゅうぜん	十全
しゅうぜん	修繕
しゅうせん	終戦
しゅうせん	周旋
じゅうせき	重責
しゅうせき	集積
じゅうぜい	重税
じゅうせい	銃声
しゅうせい	集成
しゅうせい	習性
しゅうせい	終生
しゅうせい	修正
しゅうせい	修整
じゅうすい	重水
じゅうしん	銃身
じゅうしん	重心
しゅうじん	衆人
しゅうじん	囚人
しゅうしん	終身
しゅうしん	就寝
しゅうしん	執心
じゅうしょろく	住所録
しゅうじょし	終助詞
しゅうしょくし	修飾子
じゅうしょく	住職
しゅうしょく	修飾
しゅうしょく	就職
じゅうじょう	重畳
じゅうしょう	重賞
じゅうしょう	重症
じゅうしょう	重唱
じゅうしょう	重傷
しゅうしょう	愁傷
しゅうしょう	周章
じゅうしょ	住所
じゅうじゅん	従順
しゅうじゅく	習熟
しゅうしゅく	収縮
じゅうじゅう	重々
しゅうしゅう	蒐集
しゅうしゅう	収集
しゅうしゅう	収拾
じゅうじつ	充実
しゅうじつ	終日
じゅうじ	従事
じゅうじ	十時
じゅうじ	十字
じゅうし	重視
しゅうじ	習字
しゅうじ	修辞
しゅうし	終止
しゅうし	終始
しゅうし	修士
しゅうし	宗旨
しゅうし	収支
しゅうさん	蓚酸
しゅうさん	集散
しゅうさん	衆参
じゅうさつ	銃殺
しゅうさく	習作
しゅうさく	秀作
じゅうざい	重罪
しゅうさい	秀才
しゅうさい	収載
じゅうこん	重婚
じゅうこうぎょう	重工業
じゅうこう	銃口
じゅうこう	重工
じゅうこう	重厚
しゅうごう	集合
しゅうこう	醜行
しゅうこう	修好
しゅうこう	就航
しゅうこう	周航
しゅうげん	祝言
しゅうけん	集権
じゅうけつ	充血
しゅうけつ	集結
しゅうけつ	終結
じゅうげき	銃撃
しゅうげき	襲撃
じゅうけいしょう	重軽傷
じゅうけい	重刑
しゅうけい	集計
じゅうきんぞく	重金属
しゅうきん	集金
しゅうきょく	褶曲
しゅうきょく	終曲
しゅうきょく	終局
しゅうきょうほうじん	宗教法人
じゅうぎょういん	従業員
じゆうぎょう	自由業
しゅうぎょう	終業
しゅうぎょう	修業
しゅうぎょう	就業
しゅうきょう	宗教
じゅうきょ	住居
しゅうきゅう	週給
しゅうきゅう	週休
しゅうきゅう	蹴球
じゅうき	銃器
じゅうき	什器
しゅうぎ	祝儀
しゅうき	終期
しゅうき	周期
しゅうき	周忌
しゅうかんし	週刊誌
じゅうがん	銃眼
じゅうかん	重患
じゅうかん	縦貫
じゅうかん	獣姦
しゅうかん	週間
しゅうかん	週刊
しゅうかん	習慣
しゅうがく	修学
しゅうがく	就学
しゅうかく	収穫
しゅうかい	集会
しゅうかい	周回
しゅうか	集荷
じゅうおう	縦横
しゅうえん	終焉
しゅうえき	就役
しゅうえき	収益
しゅうう	驟雨
しゅういん	衆院
しゅういつ	秀逸
じゅうい	獣医
しゅうい	拾遺
しゅうい	周囲
じゅうあつ	重圧
じゆう	自由
じゆう	事由
じゅう	中
じゅう	銃
じゅう	重
じゅう	十
じゅう	拾
しゆう	雌雄
しゆう	私有
しゅう	集
しゅう	週
しゅう	秀
しゅう	洲
しゅう	州
しゅう	周
しゅいん	主因
しゅい	首位
しゅい	趣意
しゅい	主意
しゅ	種
しゅ	朱
しゅ	主
じゃんそう	雀荘
しゃれき	社歴
しゃれい	謝礼
しゃれ	洒落
しゃりん	車輪
しゃりょう	車両
じゃり	砂利
しゃよう	社用
しゃめん	斜面
しゃめい	社名
しゃみせん	三味線
しゃみ	三味
しゃみ	沙弥
じゃま	邪魔
しゃへん	斜辺
しゃへい	遮蔽
しゃべ	喋
しゃふつ	煮沸
しゃふう	社風
しゃふ	写譜
しゃひ	社費
じゃのめ	蛇の目
しゃにむに	遮二無二に
しゃにくさい	謝肉祭
しゃない	車内
しゃない	社内
じゃどう	邪道
しゃどう	車道
しゃてき	射的
しゃてい	射程
しゃてい	舎弟
しゃっこう	赤口
しゃっけい	借景
じゃっく	惹句
しゃっきん	借金
じゃっき	惹起
じゃっかん	若干
しゃっかん	借款
しゃつ	シャツ
しゃちょう	社長
しゃちゅう	車中
しゃちゅう	社中
しゃち	鯱
しゃだんほうじん	社団法人
しゃだんき	遮断器
しゃだん	遮断
しゃだん	社団
しゃたく	社宅
しゃたい	車体
しゃたい	斜体
しゃそく	車速
しゃぞう	写像
しゃそう	車窓
しゃそう	社葬
しゃせん	車線
しゃせん	斜線
しゃぜつ	謝絶
しゃせつ	社説
しゃせい	射精
しゃせい	写生
じゃすい	邪推
じゃしん	邪心
しゃしん	写真
しゃしょく	写植
しゃじょう	謝状
しゃしょう	車掌
しゃしょう	捨象
しゃしゅつ	射出
しゃしゅ	車種
じゃじゃうま	じゃじゃ馬
しゃじつ	写実
しゃじく	車軸
しゃじ	謝辞
しゃじ	社寺
しゃし	奢侈
しゃし	社史
しゃし	斜視
しゃさつ	射殺
しゃざい	謝罪
しゃさい	車載
しゃさい	社債
しゃこう	遮光
しゃこう	車高
しゃこう	社交
しゃこう	斜行
しゃこう	斜交
しゃこ	車庫
じゃけん	邪慳
しゃけん	車検
しゃげき	射撃
しゃけ	鮭
しゃくりょう	酌量
じゃくら	雀羅
しゃくよう	借用
じゃくやく	雀躍
しゃくやく	芍薬
しゃくめい	釈明
しゃくほう	釈放
しゃくはち	尺八
じゃくはい	若輩
じゃくねん	若年
しゃくねつ	灼熱
じゃくにくきょうしょく	弱肉強食
しゃくとりむし	尺取虫
しゃくど	尺度
じゃくてん	弱点
じゃぐち	蛇口
しゃくち	借地
しゃくぜん	釈然
じゃくしん	弱震
じゃくしょう	弱小
しゃくじょう	錫杖
しやくしょ	市役所
じゃくしゃ	弱者
しゃくしじょうぎ	杓子定規
しゃくじい	石神井
じゃくし	弱視
しゃくし	杓子
しゃくざい	借財
しゃくい	爵位
じゃく	弱
じゃく	寂
しやく	試薬
しゃく	癪
しゃく	酌
しゃく	杓
しゃく	尺
しゃく	勺
しゃぎょう	社業
しゃきょう	写経
じゃき	邪気
しゃがいひ	社外秘
しゃがい	社外
しゃかい	社会
しゃか	釈迦
しゃおん	遮音
しゃおん	謝恩
しゃおく	社屋
しゃえい	射影
しゃうん	社運
しゃいん	社員
しゃい	謝意
じゃあく	邪悪
じゃ	蛇
しや	視野
しゃ	車
しゃ	謝
しゃ	紗
しゃ	社
じもん	自問
しもん	諮問
しもん	試問
しもん	指紋
しもやけ	霜焼け
しもべ	僕
しもはんき	下半期
しもばしら	霜柱
じもと	地元
しもて	下手
しもつき	霜月
しもじも	下々
しもざ	下座
じもく	耳目
しもき	下期
しもがれ	霜枯れ
しも	霜
しも	下
しめんたい	四面体
しめんそか	四面楚歌
じめん	地面
しめん	誌面
しめん	紙面
しめび	締日
しめび	締め日
しめて	締めて
しめっぽ	湿っぽ
しめつけ	締め付け
しめつけ	締めつけ
じめつ	自滅
しめつ	死滅
しめだ	締め出
しめし	示し
しめくく	締めくく
しめきりび	締切日
しめきり	締切り
しめきり	締切
しめきり	〆切り
しめきり	〆切
しめき	閉め切
しめき	締め切
じめい	自明
しめい	氏名
しめい	指命
しめい	指名
しめい	使命
しめ	閉め
しめ	締め
しめ	締
しめ	占め
しめ	湿
しめ	示
しめ	絞め
じむしょ	事務所
しむけ	仕向け
しむけ	仕向
じむきょく	事務局
じむき	事務機
じむ	事務
しみんぜい	市民税
しみん	市民
しみょう	至妙
しみゃく	支脈
しみぬき	染み抜き
しみどうふ	凍み豆腐
しみつ	染み付
しみつ	染み着
じみち	地道
しみず	清水
しみこ	染み込
じみ	地味
しみ	凍み
しみ	染み
しみ	浸み
しみ	紙魚
じまん	自慢
しまつ	始末
しまぐに	島国
じまく	字幕
しまかげ	島陰
じまえ	自前
しまい	終い
しまい	姉妹
じま	島
しま	閉ま
しま	島
しま	締ま
しま	縞
しま	仕舞
しほんきん	資本金
しほんか	資本家
しほん	資本
しぼりだ	絞り出
しぼりあげ	搾り上げ
しぼりあげ	絞り上げ
しぼつ	死没
しほうしょし	司法書士
しぼうさん	脂肪酸
しぼうこう	志望校
じぼう	自暴
じほう	時報
しぼう	脂肪
しぼう	死亡
しぼう	志望
しほう	至宝
しほう	四方
しほう	司法
しぼ	思慕
しぼ	搾
しぼ	絞
しぼ	萎
じへん	事変
しべん	至便
しべん	思弁
しべつ	死別
じへいしょう	自閉症
しへい	紙幣
しべ	蕊
しぶんぎ	四分儀
じぶん	自分
じぶん	時分
しぶん	詩文
しふん	脂粉
しふん	私憤
じぶつ	事物
しぶつ	私物
しぶしぶ	渋々
しふく	雌伏
しふく	至福
しふく	私腹
しふく	私服
しぶかわ	渋皮
しぶがき	渋柿
じふ	自負
しぶ	渋
しぶ	支部
しぶ	市部
しびれ	痺れ
じびょう	持病
じひょう	辞表
しひょう	指標
しびと	死人
じひつ	自筆
じびき	字引
じびか	耳鼻科
じひ	自費
じひ	慈悲
しひ	市費
しはんだい	師範代
じはんき	自販機
しはんき	四半期
じばん	地盤
しはん	死斑
しはん	師範
しはん	市販
しばりつけ	縛り付け
しばらく	暫く
しはらいにん	支払人
しはらい	支払
しばふ	芝生
しばづけ	柴漬け
じはつ	自発
しはつ	始発
じはだ	地肌
しばし	暫し
じばくれい	地縛霊
じばく	自爆
じはく	自白
しはいにん	支配人
しばい	芝居
しはい	賜杯
しはい	紙背
しはい	支配
じば	地場
しば	縛
しば	芝
しば	柴
しのぶ	忍
しのびよ	忍び寄
しのびこ	忍び込
しの	凌
しの	忍
しの	偲
しの	篠
しねん	思念
じねつ	地熱
しね	死ね
じぬし	地主
じにん	辞任
じにん	自認
じにん	自任
しにん	視認
しにん	死人
しにょう	し尿
しにはて	死に果て
しにたえ	死に絶え
しにせ	老舗
しなんばん	指南番
じなん	次男
しなん	至難
しなん	指南
じなり	地鳴り
しなもの	品物
しなび	萎び
しなじな	品々
しなさだめ	品定め
しなぎれ	品切れ
しなかず	品数
しなお	し直
しない	竹刀
しない	市内
しな	品
しとみ	蔀
じとく	自得
じどうしゃどう	自動車道
じどうしゃ	自動車
じどうし	自動詞
じどう	自動
じどう	児童
じとう	自答
しどう	私道
しどう	指導
しどう	始動
しとう	死闘
しと	使途
しと	使徒
してんのう	四天王
してんちょう	支店長
じてんしゃ	自転車
じでん	自伝
じてん	辞典
じてん	自転
じてん	次点
じてん	時点
じてん	事典
しでん	市電
してん	視点
してん	支点
してん	支店
してん	始点
してつ	私鉄
じてき	自適
してき	詩的
してき	至適
してき	私的
してき	指摘
してき	史的
していせき	指定席
してい	視程
してい	私邸
してい	指定
してい	師弟
じつわ	実話
じつろく	実録
しつれん	失恋
じつれい	実例
しつれい	失礼
じつりょく	実力
しつりょう	質量
じつり	実利
じづら	字面
じつよう	実用
しつよう	執拗
しつよう	執よう
しつもん	質問
じつめい	実名
しつめい	失明
じつむ	実務
しつむ	執務
しつぼう	失望
じつぼ	実母
しっぽ	尻尾
しっぺい	疾病
じつぶつ	実物
しっぷう	疾風
じっぷ	実父
しっぷ	湿布
しっぴつしゃ	執筆者
しっぴつ	執筆
じっぴ	実費
しっぱい	失敗
しつねん	失念
しつないがく	室内楽
しつない	室内
じつどう	実働
しっとう	執刀
しつど	湿度
しっと	嫉妬
しつでん	湿田
しってん	失点
しつてき	質的
しっつい	失墜
じっちょく	実直
しつちょう	室長
しっちょう	失調
じっち	実地
しっち	湿地
じつだん	実弾
じったい	実態
じったい	実体
しったい	失態
しった	叱咤
じつぞん	実存
じっそく	実測
しっそく	失速
じつぞう	実像
じっそう	実装
しっそう	疾走
しっそう	失踪
しっそ	質素
じっせん	実践
じっせん	実線
じっせん	実戦
じっせき	実績
しっせき	叱責
じっせいかつ	実生活
じっせい	実勢
しっせい	失政
じっすう	実数
しっしん	湿疹
しっしん	失神
しっしょく	失職
じつじょう	実状
じつじょう	実情
じっしょう	実証
しっしょう	失笑
しつじゅん	湿潤
じっしゅう	実習
じっしゅう	実収
じっしゃかい	実社会
じっしゃ	実写
じっしつ	実質
しつじつ	質実
じっし	実視
じっし	実施
じっし	実子
しつじ	執事
じっさく	実作
しっさく	失策
じつざい	実在
じっさい	実際
じっこん	昵懇
じっこん	実根
しつごしょう	失語症
しっこく	桎梏
じっこう	実行
じっこう	実効
しっこう	失効
しっこう	執行
じつげん	実現
じっけん	実験
じっけん	実権
じっけん	実検
しつげん	湿原
しつげん	失言
しっけん	失権
じっけい	実兄
じっけい	実刑
しっけい	失敬
しつけ	躾け
しつけ	躾
しつけ	仕付け
しっけ	湿気
しっきん	失禁
じつぎょうか	実業家
じつぎょう	実業
じっきょう	実況
しつぎょう	失業
しっきゃく	失脚
じつぎ	実技
じっき	実機
しつぎ	質疑
しっき	漆器
じっかん	十干
じっかん	実感
しつかん	質感
しっかん	疾患
しっかく	失格
じつがい	実害
しつがい	室外
じっか	実家
しっか	失火
しつおん	室温
じつえん	実演
じつえき	実益
しつう	止痛
じついん	実印
しつい	失意
じつ	実
しつ	質
しつ	室
しちょく	司直
しちょうそん	市町村
じちょう	自嘲
じちょう	自重
じちょう	次長
しちよう	七曜
しちょう	試聴
しちょう	視聴
しちょう	支庁
しちょう	思潮
しちょう	市長
しちゅう	支柱
しちゅう	市中
しちや	質屋
しちめんどう	しち面倒
しちなん	七難
しちてんばっとう	七転八倒
じちたい	自治体
しちしょう	七生
しちけん	質権
しちぐさ	質草
じちかい	自治会
じち	自治
しち	質
しち	七
じだん	示談
じだん	次段
じたん	時短
しだん	指弾
しだん	師団
したわし	慕わし
しだれ	垂れ
じだらく	自堕落
したむき	下向き
したみ	下見
したまわ	下回
したまち	下町
したび	下火
したばたらき	下働き
したね	下値
したどり	下取り
したて	仕立て
したて	下手
したづみ	下積み
したっぱ	下っ端
したたらず	舌足らず
したため	認め
したたか	強か
したた	滴
したしらべ	下調べ
したじき	下敷
しだし	仕出し
したじ	下地
したし	親し
したざわり	舌触り
じたく	自宅
したく	支度
したぎ	下着
したがって	従って
したがき	下書き
したが	従
したえ	下絵
したうけ	下請け
じだいしゅぎ	事大主義
じだいげき	時代劇
じだい	地代
じだい	次代
じだい	時代
じたい	辞退
じたい	自体
じたい	字体
じたい	事態
しだい	次第
しだい	私大
したい	肢体
したい	死体
したい	姿態
じだ	耳朶
じた	自他
した	慕
した	舌
した	下
じそん	自尊
じそん	自存
しそん	子孫
じぞく	持続
じそく	時速
しぞく	氏族
しぞく	士族
しそく	子息
しそく	四則
しそうか	思想家
じぞう	地蔵
しぞう	死蔵
しそう	試走
しそう	思想
しそ	紫蘇
じぜん	次善
じぜん	慈善
じぜん	事前
じせん	自選
じせん	自薦
しぜん	自然
しせん	視線
しせん	死線
しせん	支線
しせる	死せる
じせつ	自説
じせつ	時節
しせつ	私設
しせつ	施設
しせつ	使節
じせき	自責
じせき	自席
じせき	次席
しせき	歯石
しせき	史跡
しせいじ	私生児
しせいかん	死生観
しせいかつ	私生活
じせい	自制
じせい	時勢
じせい	時制
じせい	時世
しせい	私製
しせい	施政
しせい	市政
しせい	市制
しせい	市井
しせい	姿勢
しずめ	鎮め
しずめ	沈め
しずめ	静め
しずまりかえ	静まり返
しずま	鎮ま
しずま	静ま
しずけさ	静けさ
しずく	滴
しずく	雫
しずか	静か
じすう	次数
じすう	字数
しすう	指数
じすい	自炊
しず	沈
じしんは	地震波
じしん	地震
じしん	自身
じしん	自信
じしん	磁針
しじん	詩人
ししん	視診
ししん	私心
ししん	私信
ししん	指針
ししょばこ	私書箱
じじょでん	自叙伝
じしょく	辞職
ししょく	試食
じじょうじばく	自縄自縛
じじょう	自乗
じじょう	事情
じしょう	自称
じしょう	次章
じしょう	事象
しじょう	誌上
しじょう	試乗
しじょう	至上
しじょう	紙上
しじょう	私情
しじょう	市場
しじょう	史上
ししょう	死傷
ししょう	支障
ししょう	師匠
ししょう	刺傷
じじょ	自序
じじょ	次女
じしょ	地所
じしょ	辞書
じしょ	自署
しじょ	子女
ししょ	支署
ししょ	支所
ししょ	司書
ししゅんき	思春期
じじゅん	耳順
しじゅん	示準
ししゅつ	支出
じしゅく	自粛
しじゅく	私塾
しじゅうそう	四重奏
ししゅうき	思秋期
しじゅうから	四十雀
じじゅう	自重
じじゅう	侍従
じしゅう	自習
しじゅう	始終
しじゅう	四重
ししゅう	詩集
ししゅう	屍臭
ししゅう	刺繍
じしゅ	自首
じしゅ	自主
じしゅ	字種
ししゅ	死守
ししゃちょう	支社長
ししゃごにゅう	四捨五入
じじゃく	自若
じしゃく	磁石
ししゃく	子爵
じしゃ	自社
じしゃ	寺社
ししゃ	試射
ししゃ	試写
ししゃ	死者
ししゃ	支社
ししゃ	使者
しじみ	蜆
ししまい	獅子舞
じじつじょう	事実上
じじつ	事実
じしつ	自室
じしつ	自失
ししつ	資質
じじこくこく	時々刻々
じじ	爺
じじ	時事
じし	次子
しじ	私事
しじ	支持
しじ	指示
しじ	師事
しし	獅子
しし	四肢
じさん	自賛
じさん	持参
しさん	資産
しさん	試算
しさん	四散
じさつ	自殺
しさつ	視察
しさつ	刺殺
じざけ	地酒
じさげ	字下げ
じさく	自作
しさく	試作
しさく	施策
しさく	思索
じざい	自在
しざい	資材
しざい	私財
しさい	子細
しさい	司祭
じさ	時差
しさ	示唆
しこん	歯根
しこん	紫紺
しごと	仕事
じごく	地獄
じこく	自国
じこく	時刻
しごく	至極
じごうじとく	自業自得
じごう	次号
じこう	次項
じこう	時効
じこう	時候
じこう	事項
しこう	嗜好
しこう	歯垢
しこう	試行
しこう	至高
しこう	施行
しこう	指向
しこう	思考
しこう	志向
じご	事後
じこ	自己
じこ	事故
しご	私語
しご	死語
しご	死後
しご	扱
しこ	仕込
しけんへん	試験片
しけんじょう	試験場
しけんかん	試験管
じげん	次元
じげん	時限
じけん	事件
しげん	資源
しげん	至言
しけん	試験
しけん	私見
しげみ	茂み
じけつ	自決
しけつ	止血
しげき	刺激
じけい	次兄
しけい	私刑
しけい	死刑
しげ	茂
しげ	繁
しぐれ	時雨
しくはっく	四苦八苦
じくじ	忸怩
しぐさ	仕草
じくう	時空
じく	軸
じく	字句
しく	市区
しく	仕組
しきんぐり	資金繰り
しぎん	詩吟
しきん	資金
しきん	至近
しきり	仕切り
じきょく	磁極
じきょく	時局
しきょく	支局
じぎょうぶ	事業部
しきょうひん	試供品
じぎょうぬし	事業主
じぎょうしょ	事業所
じぎょう	事業
じきょう	自供
しぎょう	始業
しきょう	市況
しきょう	司教
じきょ	辞去
しきょ	死去
じきゅう	自給
じきゅう	時給
じきゅう	持久
しきゅう	至急
しきゅう	支給
しきゅう	子宮
じぎゃく	自虐
しぎゃく	嗜虐
しぎやき	鴫焼き
しきもう	色盲
しきべつ	識別
しきぶ	式部
しきふ	敷布
じきひつ	直筆
しきてん	式典
しきつめ	敷き詰め
しきちょう	色調
しきち	敷地
しきそう	色相
じきそ	直訴
しきそ	色素
しきじょう	式場
しきしゃ	識者
じきじき	直々
しきじ	式辞
しきし	色紙
じきさん	直参
しきさい	色彩
しききん	敷金
しきいち	しきい値
しきいき	識閾
しきい	敷居
じぎ	辞儀
じぎ	字義
じき	自棄
じき	磁気
じき	磁器
じき	次期
じき	時機
じき	時期
しぎ	鴫
しぎ	市議
しぎ	仕儀
しき	式
しき	死期
しき	指揮
しき	始期
しき	四季
しき	仕切
じかんわり	時間割
じかんたい	時間帯
じかんぎれ	時間切れ
じかんがい	時間外
じかん	次官
じかん	時間
しがん	志願
しかん	弛緩
しかん	士官
しかん	仕官
しかるべき	然るべき
しかりつけ	叱りつけ
しかり	然り
じかようしゃ	自家用車
じかよう	自家用
しかばね	屍
じかつ	自活
じがため	地固め
しかたな	仕方な
しかた	仕方
じがぞう	自画像
じかせい	自家製
しかけ	仕掛け
しかけ	仕掛
じがく	自学
じかく	自覚
じかく	字画
しがく	歯学
しがく	私学
しがく	志学
しがく	史学
しかく	資格
しかく	視覚
しかく	死角
しかく	四角
しかえし	仕返し
しがいせん	紫外線
じかい	次回
しがい	死骸
しがい	市街
しがい	市外
しかい	歯科医
しかい	視界
しかい	市会
しかい	司会
じが	自画
じが	自我
じか	自家
じか	時価
じか	時下
しか	叱
しか	鹿
しか	歯科
しか	市価
しおん	紫苑
しおり	栞
しおやき	塩焼
しおみず	塩水
しおひがり	潮干狩
しおづけ	塩漬け
しおけ	塩気
しおくり	仕送り
しおから	塩辛
しお	潮
しお	汐
しお	塩
じえん	自演
しえん	紫煙
しえん	私怨
しえん	支援
じぇっとき	ジェット機
しえき	私益
しえき	使役
じえい	自衛
じえい	自営
しえい	私営
しえい	市営
しうんてん	試運転
しうち	仕打
じいん	寺院
しいん	試飲
しいん	死因
しいん	子音
しいれ	仕入れ
しいたげ	虐げ
しいたけ	椎茸
じいしき	自意識
しいく	飼育
しいか	詩歌
じい	爺
じい	辞意
じい	自慰
しい	恣意
しい	椎
しい	私意
しい	思惟
しい	四囲
しい	強い
しあん	私案
しあん	思案
しあわせ	幸せ
じあげ	地上げ
しあげ	仕上げ
しあが	仕上が
しあが	仕上
じあい	自愛
じあい	慈愛
しあい	試合
じ	地
じ	辞
じ	痔
じ	時
じ	持
じ	字
じ	侍
し	巳
し	敷
し	凍
し	知
し	染
し	資
し	詩
し	至
し	氏
し	死
し	志
し	師
し	市
し	士
し	四
さんろく	山麓
さんれつ	参列
さんりん	山林
ざんりゅう	残留
さんりゅう	三流
さんらん	産卵
さんらん	散乱
さんようちゅう	三葉虫
さんよう	算用
ざんよ	残余
さんよ	参与
さんゆ	産油
さんもんばん	三文判
さんめんろっぴ	三面六臂
ざんむ	残務
さんみゃく	山脈
さんみ	酸味
さんみ	三位
さんまん	散漫
ざんまい	三昧
ざんぼう	讒謗
さんぼう	参謀
さんぽ	散歩
さんぶん	散文
さんぶん	三分
さんぶつ	産物
さんふじんか	産婦人科
さんぷく	山腹
ざんぶ	残部
さんぷ	産婦
さんぷ	散布
ざんぴん	残品
さんびか	賛美歌
さんぴ	賛否
さんび	賛美
ざんぱん	残飯
さんばん	三番
さんぱつ	散髪
さんぱつ	散発
さんばし	桟橋
ざんぱい	惨敗
さんぱい	惨敗
さんぱい	参拝
さんば	産婆
ざんねん	残念
さんにんしょう	三人称
ざんにん	残忍
さんにん	三人
さんにゅう	算入
さんにゅう	参入
さんどう	賛同
さんどう	参道
さんど	サンド
ざんてい	暫定
さんてい	算定
さんちょう	山頂
さんちゅう	山中
さんち	産地
さんち	山地
さんだんばら	三段腹
さんだん	算段
さんだん	散弾
さんたん	賛嘆
さんたん	惨澹
さんだつ	簒奪
ざんだか	残高
さんだい	産大
ざんぞん	残存
ざんそん	残存
さんそん	山村
さんぞく	山賊
ざんぞう	残像
さんそう	山荘
さんそ	酸素
さんせんそうもく	山川草木
さんぜん	燦然
さんせん	参戦
ざんせつ	残雪
さんせき	山積
さんせい	酸性
さんせい	賛成
さんせい	参政
さんすう	算数
さんすい	散水
さんすい	撒水
ざんしん	斬新
さんしん	三振
さんじょく	産褥
さんしょく	蚕食
さんしょく	三食
さんしょううお	鯢
ざんしょう	残照
さんじょう	惨状
さんじょう	山上
さんじょう	参上
さんしょう	参照
さんしょう	三唱
ざんしょ	残暑
さんじょ	賛助
さんじゅつ	算術
さんしゅつ	算出
さんしゅつ	産出
さんじゅうく	三重苦
さんしゅう	参集
さんじゅ	傘寿
ざんじ	暫時
ざんし	残滓
さんじ	賛辞
さんじ	産児
さんじ	惨事
さんじ	参事
さんし	蚕糸
さんざん	散々
さんさん	燦々
ざんさつ	惨殺
さんさく	散策
ざんさい	残滓
さんざい	散財
さんざい	散在
さんさい	山菜
さんこつ	散骨
さんごしょう	珊瑚礁
ざんこく	残酷
さんこうしょ	参考書
ざんごう	塹壕
さんこう	参考
さんご	産後
さんご	珊瑚
ざんげん	讒言
さんけん	散見
さんけん	三権
さんげき	惨劇
さんけい	参詣
ざんげ	懺悔
さんけ	産気
さんぐう	参宮
ざんきん	残金
ざんぎょう	残業
ざんきょう	残響
さんぎょう	産業
さんきょう	山峡
さんきゅう	産休
ざんぎゃく	残虐
さんかんしおん	三寒四温
さんかん	山間
さんかん	参観
さんがにち	三箇日
さんがにち	三ヶ日
さんがにち	三が日
さんかしゃ	参加者
さんかくちゅう	三角柱
ざんがく	残額
さんがく	産額
さんがく	山岳
さんかく	参画
さんかく	三角
ざんがい	残骸
さんがい	惨害
さんがい	三界
さんかい	散会
さんかい	参会
さんが	山河
さんが	参賀
さんか	酸化
さんか	賛歌
さんか	讃歌
さんか	惨禍
さんか	参加
さんか	傘下
ざんえい	残映
さんいん	産院
さんいん	参院
さんいつ	散逸
さんい	賛意
ざん	残
さん	酸
さん	賛
さん	算
さん	産
さん	散
さん	参
さん	三
さわん	左腕
さわら	鰆
さわら	椹
さわやか	爽やか
さわがし	騒がし
さわかい	茶話会
さわ	沢
さわ	騒
さわ	触
さわ	障
ざれぶみ	戯れ文
ざれごと	戯れ言
さるどし	申年
さるぢえ	猿知恵
さるすべり	百日紅
さること	然ること
さる	申
さる	猿
さらに	更に
さらし	晒
さらさら	更々
さらけだ	さらけ出
さらいねん	再来年
さらいしゅう	再来週
さらいげつ	再来月
ざら	皿
さら	曝
さら	晒
さら	皿
さら	拐
さよく	左翼
さよう	作用
ざゆう	座右
さゆう	左右
ざやく	座薬
さやあて	鞘当て
さや	鞘
さもん	査問
さめはだ	鮫肌
さめ	冷め
さめ	醒め
さめ	鮫
さめ	覚め
さむらい	侍
さむさ	寒さ
さむけ	寒気
さむえ	作務衣
さむ	寒
さみだれ	五月雨
さみし	淋し
さみし	寂し
さまよ	さ迷
さまつ	瑣末
さまたげ	妨げ
さまざま	様々
さまがわり	様変わり
さまがわり	様変り
さま	冷ま
さま	様
さま	覚ま
さほど	然程
さぼう	砂防
さほう	作法
さへん	左辺
さべつ	差別
さぶん	差分
ざぶとん	座布団
ざぶとん	座蒲団
さびれ	寂れ
ざひょう	座標
さびつ	錆びつ
さびし	淋し
さびし	寂し
さび	錆び
さび	錆
さはんじ	茶飯事
さばく	砂漠
さはい	差配
さば	捌
さば	鯖
さば	裁
さは	左派
さなぎ	蛹
さとめ	差し止め
さどく	査読
さどう	茶道
さどう	作動
さとう	砂糖
さと	里
さと	諭
さと	敏
さと	聡
さと	悟
さと	郷
さてい	査定
さつりく	殺戮
ざつよう	雑用
ざつむ	雑務
さつまいも	薩摩芋
ざっぽう	雑報
ざつぶん	雑文
ざっぴ	雑費
さっぴ	さっ引
さつばつ	殺伐
ざっぱく	雑駁
ざっぱい	雑俳
ざつねん	雑念
ざっとう	雑踏
さっとう	殺到
さっち	察知
ざつだん	雑談
ざった	雑多
さっそく	早速
ざっそう	雑草
さっそう	颯爽
ざつぜん	雑然
さっすう	冊数
さつじんき	殺人鬼
さつじん	殺人
さっしん	刷新
ざっしょく	雑食
さっしょう	殺傷
ざっしゅ	雑種
ざつじ	雑事
ざっし	雑誌
さっし	察し
さっし	冊子
さっこん	昨今
さっきん	殺菌
さっきょく	作曲
ざっきょ	雑居
さっきゅう	早急
ざっき	雑記
さつき	皐月
さつき	五月
さっき	殺気
ざつがく	雑学
さっかく	錯覚
さつがい	殺害
ざっか	雑貨
さっか	擦過
さっか	作家
ざつおん	雑音
ざつえき	雑益
さつえい	撮影
さつい	殺意
ざつ	雑
さつ	札
さつ	察
さつ	冊
さっ	察
ざちょう	座長
ざだん	座談
さたん	左端
さだめ	定め
さだま	定ま
さだか	定か
ざた	沙汰
さた	沙汰
さそん	差損
さそり	蠍
ざぞう	座像
さそいだ	誘い出
さそいこ	誘い込
さそいかけ	誘いかけ
さそ	誘
ざぜん	座禅
ざぜん	坐禅
させん	鎖線
させん	左遷
ざせつ	挫折
させつ	左折
ざせき	座席
さずけ	授け
さずか	授か
さすが	流石
さじん	砂塵
さしわたし	差渡し
さしわた	差し渡
ざしょう	挫傷
ざしょう	座礁
さしょう	査証
さしょう	些少
さしゅう	査収
さしゅ	詐取
さしもどし	差戻し
さしもど	差し戻
さしむけ	差し向け
さしむかい	差向い
さしむか	差し向か
さしみず	差水
さしみず	差し水
さしみ	刺身
さしまわ	差し回
さしひき	差引
さしひかえ	差し控え
さしひ	差引
さしひ	差し引
さしどめ	差止め
さしとめ	差し止め
さしでがまし	差し出がまし
さしつかえ	差し支え
さしだしにん	差出人
さしだ	差し出
さしせま	差し迫
さしず	指図
さししめ	指し示
さしさわり	差障り
さしさわ	差し障
さしこ	差し込
ざしき	座敷
さじき	桟敷
さしき	挿し木
さしがね	差金
さしがね	差し金
さしかけ	差しかけ
さしかえ	差替え
さしかえ	差換え
さしかえ	差し替え
さしかえ	差し換え
さしおさえ	差押え
さしおさえ	差押
さしおさえ	差し押さえ
さしおさえ	差し押え
さしえ	挿絵
さしいれ	差入れ
さしいれ	差し入れ
さしあた	差し当た
さしあげ	差し上げ
さじ	匙
さじ	些事
さざんか	山茶花
ささら	簓
ささや	囁
さざなみ	漣
さざなみ	さざ波
ささつ	査察
ささげ	捧げ
ささえ	支え
ささい	些細
ささ	刺さ
ささ	笹
さこく	鎖国
ざこう	座高
さげん	左舷
さけめ	裂け目
さけい	左傾
ざけ	酒
さげ	提げ
さげ	下げ
さけ	避け
さけ	酒
さけ	鮭
さけ	叫
ざくろ	石榴
さくれつ	炸裂
さくれい	作例
さくりゃく	策略
さぐりだ	探り出
さぐりあて	探り当て
さくらん	錯乱
さくらもち	桜餅
さくらがい	桜貝
さくら	櫻
さくら	桜
さくゆ	搾油
さくや	昨夜
さくもつ	作物
さくぶん	作文
さくふう	作風
さくひん	作品
さくひょう	作表
さくばん	昨晩
さくねんど	昨年度
さくねん	昨年
さくにゅう	搾乳
さくどう	策動
さくとう	昨冬
さくてき	索敵
さくてい	策定
さくつけ	作付
さくそう	錯綜
さくせん	作戦
さくせい	作製
さくせい	作成
さくず	作図
さくじょ	削除
さくしゅ	搾取
さくしゃ	作者
さくじつ	昨日
さくじ	作字
さくじ	作事
さくし	策士
さくし	作詞
さくご	錯誤
さくげん	削減
さくがら	作柄
さくが	作画
さくいん	索引
さくいおん	錯イオン
さくい	作為
さくい	作意
さぐ	探
さく	索
さく	策
さく	柵
さく	作
さきん	先ん
さぎょうぎ	作業着
さぎょう	作業
さきゆき	先行き
さきゅう	砂丘
さきもの	先物
さきまわり	先回り
さきほど	先程
さきばし	先走
さきどり	先取り
さきだて	先立て
さきだ	先立
さきさま	先様
さきざき	先々
さきごろ	先頃
さきがけ	先駆け
さきおくり	先送り
ざき	崎
さぎ	鷺
さぎ	詐欺
さき	前
さき	先
さき	左記
さかん	盛ん
さかん	左官
さかん	佐官
さかり	盛り
さから	逆ら
さかや	酒屋
さかもり	酒盛り
さかむし	酒蒸し
さかむし	酒蒸
さかみち	坂道
さかま	逆巻
さかば	酒場
さかのぼ	遡
さかな	肴
さかな	魚
さかて	逆手
さかづき	杯
さかだち	逆立ち
さかだち	逆立
さかずき	杯
さがしだ	捜し出
さがしあて	捜し当て
さかさ	逆さ
さがく	差額
さかき	榊
さかえ	栄え
さかえ	栄
さかいめ	境目
さかい	境
さが	探
さが	捜
さが	性
さが	下が
さか	盛
さか	坂
さお	棹
さお	竿
さえつ	査閲
さえぎ	遮
さえき	差益
さえ	冴え
さいわい	幸い
さいわい	幸
さいろく	載録
さいろく	採録
さいれい	祭礼
ざいりょく	財力
ざいりょう	材料
さいりょう	裁量
さいりょう	最良
ざいりゅう	在留
ざいらい	在来
さいらい	再来
さいよう	採用
さいゆうせん	最優先
ざいもく	材木
さいもく	細目
ざいむ	財務
さいむ	債務
さいみん	細民
さいみん	催眠
さいみつ	細密
さいまつ	歳末
さいほくたん	最北端
ざいほう	財宝
さいぼう	細胞
さいほう	裁縫
さいへん	再編
さいぶん	細分
さいぶ	細部
さいふ	財布
さいひ	歳費
さいひ	採否
さいばんしょ	裁判所
さいばんかん	裁判官
さいばん	裁判
さいはん	再販
さいはん	再犯
ざいばつ	財閥
さいはつ	再発
さいばし	才走
さいばい	栽培
さいはい	采配
さいのう	才能
さいねんちょう	最年長
さいねんしょう	最年少
さいねん	再燃
ざいにん	罪人
ざいにん	在任
さいにん	再任
さいにゅう	歳入
ざいにち	在日
さいなんたん	最南端
さいなん	災難
さいな	苛
さいどく	再読
さいとうにゅう	再投入
さいど	彩度
さいど	再度
さいてん	祭典
さいてん	採点
さいてき	最適
さいていげん	最低限
さいてい	裁定
さいてい	最低
さいちょう	最長
さいちゅう	最中
さいち	才知
ざいだんほうじん	財団法人
ざいだん	財団
さいだん	裁断
さいだん	祭壇
さいたん	最短
ざいたく	在宅
さいたく	採択
さいだいち	最大値
さいだいげん	最大限
さいだい	細大
さいだい	最大
さいたい	妻帯
さいた	最多
さいそく	催促
さいそう	再送
さいせんたん	最先端
さいぜんせん	最前線
さいぜん	最善
さいぜん	最前
さいせん	再選
ざいせき	在籍
さいせき	砕石
さいせき	採石
さいせいき	最盛期
ざいせい	財政
さいせい	再製
さいせい	再生
さいすん	採寸
さいしん	細心
さいしん	最新
さいしん	再審
ざいしょく	在職
さいしょく	菜食
さいしょく	才色
さいしょく	彩色
さいしょうち	最小値
さいしょうげん	最小限
ざいじょう	罪状
さいじょう	最上
さいしょう	最少
さいしょう	最小
ざいしょ	在所
さいじょ	才女
さいしょ	最初
さいしゅつ	歳出
さいしゅうかい	最終回
ざいじゅう	在住
さいしゅう	採集
さいしゅう	最終
さいしゅ	採取
ざいしつ	材質
さいじつ	祭日
さいじき	歳時記
さいし	妻子
ざいさん	財産
さいさん	採算
さいさん	再三
さいさ	歳差
さいこん	再婚
さいこく	催告
さいこうほう	最高峰
さいこうちょう	最高潮
さいこうさい	最高裁
ざいごう	在郷
ざいこう	在校
さいこう	採鉱
さいこう	最高
さいこう	再考
さいこう	再興
ざいこ	在庫
さいご	最後
さいご	最期
さいこ	最古
ざいげん	財源
さいげん	際限
さいげん	再現
さいけん	再建
さいけん	債権
さいけん	債券
さいげつ	歳月
さいけつ	裁決
さいけつ	採血
さいけつ	採決
ざいけい	財経
ざいけい	財形
さいけい	再掲
さいくつ	採掘
さいく	細工
ざいきん	在勤
さいきん	細菌
さいきん	最近
ざいきょう	在京
さいきょう	最強
さいきゅう	最急
さいぎ	猜疑
さいき	才気
さいき	再起
さいき	再帰
さいき	催奇
ざいがく	在学
さいかく	才覚
ざいがい	在外
ざいかい	財界
さいがい	災害
さいかい	再開
さいかい	再会
ざいか	財貨
さいか	裁可
さいか	最下
さいおうがうま	塞翁が馬
さいえん	菜園
さいえん	才媛
さいえん	再演
さいう	最右
ざいい	在位
ざいあく	罪悪
さいあく	最悪
さいあい	最愛
ざい	財
ざい	罪
ざい	材
さい	際
さい	最
さい	差異
ざ	座
さ	裂
さ	挿
さ	射
さ	指
さ	刺
さ	咲
さ	鎖
さ	差
さ	去
さ	割
こんわく	困惑
こんわ	混和
こんわ	懇話
こんれい	婚礼
こんりんざい	金輪際
こんりゅう	根粒
こんりゅう	建立
こんらん	混乱
こんよう	混用
こんやく	婚約
こんや	今夜
こんもう	根毛
こんもう	懇望
こんめい	混迷
こんぽん	根本
こんぽう	梱包
こんぼう	棍棒
こんぼう	混紡
こんぼう	懇望
こんぺき	紺碧
こんぶ	昆布
こんぱん	今般
こんばん	今晩
こんぱく	魂魄
こんぱい	困憊
こんねんど	今年度
こんねん	今年
こんにゅう	混入
こんにゃく	蒟蒻
こんにち	今日
こんなん	困難
こんとん	混沌
こんどう	混同
こんどう	金堂
こんど	今度
こんてい	根底
こんちゅう	昆虫
こんち	根治
こんだん	懇談
こんたん	魂胆
こんだて	献立
こんだく	溷濁
こんだく	混濁
こんぜん	渾然
こんぜん	混然
こんせん	混戦
こんぜつ	根絶
こんせつ	懇切
こんせき	痕跡
こんせき	今夕
こんせい	混成
こんせい	懇請
こんすい	昏睡
こんしん	渾身
こんしん	混信
こんしん	懇親
ごんじょう	言上
こんじょう	根性
こんじょう	懇情
こんじょう	今生
こんしゅん	今春
こんしゅう	今週
こんしゅう	今秋
こんじゃく	今昔
こんじき	金色
こんじ	根治
こんじ	今時
こんざつ	混雑
こんざい	混在
こんさい	根菜
こんこん	渾々
こんごう	混合
こんごう	根号
こんこう	混交
こんご	今後
こんげん	根源
こんげつ	今月
こんけつ	混血
ごんげ	権化
こんく	困苦
ごんぎょう	勤行
こんきょ	根拠
こんきゅう	困窮
こんきゃく	困却
こんぎ	婚儀
こんき	根気
こんき	婚期
こんき	今期
こんがん	懇願
こんかん	根幹
こんかい	今回
こんか	婚家
こんか	今夏
こんいん	婚姻
こんい	懇意
こん	紺
こん	混
こん	根
こわれ	壊れ
こわね	声音
こわいろ	声色
こわ	怖
こわ	恐
こわ	壊
ころもがえ	衣更え
ころも	衣
ごろね	ごろ寝
ころしあ	殺し合
ころげこ	転げ込
ごろく	語録
ころがりこ	転がり込
ころが	転が
ころう	古老
ころあい	頃合い
ごろ	語呂
ころ	転
ころ	殺
ころ	頃
ごれんらく	御連絡
ごれんらく	ご連絡
これみよがし	これ見よがし
これいじょう	これ以上
ごりん	五輪
こりょうり	小料理
ごりょうしん	御両親
ごりょうしん	ご両親
ごりょうしょう	御了承
ごりょうしょう	ご了承
ごりよう	御利用
ごりよう	ご利用
こりょ	顧慮
ごりゅうせい	御隆盛
ごりゅうせい	ご隆盛
ごりやく	ご利益
ごりむちゅう	五里霧中
こりつ	孤立
ごりかい	御理解
ごりかい	ご理解
こりー	コリー
こり	懲り
ごらん	御覧
ごらん	ご覧
こらしめ	懲らしめ
ごらく	娯楽
こらえしょう	堪え性
こらえ	堪え
ごらいりん	御来臨
ごらいりん	ご来臨
ごらいてん	御来店
ごらいてん	ご来店
ごらいじょう	御来場
ごらいじょう	ご来場
ごらいこう	御来光
ごらいこう	ご来光
こらい	古来
こら	懲ら
こら	凝ら
こよみ	暦
ごようめい	御用命
ごようめい	ご用命
ごようはじめ	御用始め
ごようたつ	御用達
ごようおさめ	御用納め
ごよう	誤用
ごよう	御用
こよう	雇用
こよい	今宵
こゆび	小指
こゆう	固有
こやま	小山
ごやく	誤訳
こや	肥や
こや	小屋
こもんじょ	古文書
こもん	小紋
こもん	顧問
こもり	子守
こもの	小物
こもち	子持ち
こもち	子持
こもじ	小文字
ごもく	五目
こも	籠
こも	篭
ごめん	御免
ごめいわく	御迷惑
ごめいわく	ご迷惑
こめい	古名
こめ	籠め
こめ	篭め
こめ	米
こめ	込め
こむそう	虚無僧
こむすび	小結
こむぎこ	小麦粉
こむぎ	小麦
ごみばこ	ゴミ箱
こみち	小路
こみち	小道
こみい	込み入
こみあげ	こみ上げ
こみあ	込み合
ごみ	塵
こみ	込
こまわり	小回り
こまりはて	困り果て
こまやか	細やか
こまね	拱
こまっちゃくれ	こまっしゃくれ
ごまつ	語末
こまつ	小松
こまた	小股
こましゃくれ	こまっしゃくれ
こまく	鼓膜
こまぎれ	細切れ
ごまか	誤魔化
こまか	細か
ごま	胡麻
こま	困
こま	駒
こぼれおち	こぼれ落ち
ごほうめい	御芳名
ごほうめい	ご芳名
ごほうねん	御放念
ごほうねん	ご放念
ごほうし	御芳志
ごほうし	御奉仕
ごほうし	ご芳志
ごほうし	ご奉仕
ごほうこく	御報告
ごほうこく	ご報告
ごほう	誤報
ごべんたつ	御鞭撻
ごへんそう	御返送
ごへんそう	ご返送
ごへんじ	御返事
ごへんじ	ご返事
ごへんかん	誤変換
こべつ	戸別
こべつ	個別
ごへい	語弊
ごぶん	誤聞
こぶん	古文
こふん	古墳
こぶり	小降り
こぶし	小節
こぶし	拳
ごぶさた	御無沙汰
ごふく	呉服
こふきいも	粉吹き芋
こふう	古風
ごぶ	五分
こぶ	瘤
こびりつ	こびり付
ごびゅう	誤謬
こびと	小人
ごび	語尾
こび	媚び
こはんとき	小半時
ごはんじょう	御繁盛
ごはんじょう	ご繁盛
こばんざめ	小判鮫
ごはんえい	御繁栄
ごはんえい	ご繁栄
ごばん	碁盤
ごはん	御飯
ごはん	ご飯
こばん	小判
こはん	湖畔
こはる	小春
こばなし	小話
こばな	小鼻
ごはってん	御発展
ごはってん	ご発展
こはぜ	鞐
ごはさん	御破算
ごはさん	ご破算
ごはいりょ	御配慮
ごはいりょ	ご配慮
こば	拒
このんで	好んで
このよう	この様
このもし	好もし
このみ	木の実
このまし	好まし
このたび	この度
このさい	この際
このごろ	この頃
このうえな	この上無
このうえな	この上な
このあいだ	この間
この	此の
この	好
こねまわ	こね回
こねあげ	こね上げ
ごにん	誤認
こにくらし	小憎らし
こなごな	粉々
こな	粉
ことわざ	諺
ことわ	断わ
ことわ	断
ことり	小鳥
こども	子供
こども	子ども
ことほ	祝
ことぶき	寿
ことば	詞
ことば	言葉
ことに	異に
ことな	異な
ことづけ	言付け
ことたり	事足り
ごとし	如し
ことし	今年
ことさら	殊更
ことこまか	事細か
ごとく	如く
こどく	孤独
ごとき	如き
ことがら	事柄
ことか	事欠
ごとうちゃく	御到着
ごとうちゃく	ご到着
ごどうさ	誤動作
こどうぐ	小道具
ごとう	語頭
こどう	鼓動
ことう	孤島
ことあげ	言挙げ
ごと	毎
こと	殊
こと	事
こと	古都
こと	琴
こと	異
ごてん	御殿
こてん	古典
こてん	個展
こてさき	小手先
こてき	鼓笛
こていよくき	固定翼機
こてい	固定
こて	鏝
こて	小手
こっぺん	骨片
こつばん	骨盤
こっぱ	木端
こつにく	骨肉
こっとう	骨董
こづつみ	小包
こつつぼ	骨壷
こっちょう	骨頂
こっせつ	骨折
こつずい	骨髄
こっし	骨子
こっこく	刻々
こっこうりつ	国公立
ごつごう	御都合
ごつごう	ご都合
こっこう	国交
こっこ	国庫
こっけん	国権
こっけい	滑稽
こっきょう	国境
こっき	国旗
こっき	克己
こっかん	酷寒
こっかく	骨格
こづかい	小遣い
こっかい	黒海
こっかい	国会
こっか	国歌
こっか	国家
ごつうち	御通知
ごつうち	ご通知
こつ	骨
ごちょう	語調
こちょう	蝴蝶
こちょう	誇張
こちょう	胡蝶
ごちゅうもん	御注文
ごちゅうもん	ご注文
ごちゅうい	御注意
ごちゅうい	ご注意
こちゃく	固着
ごちそう	御馳走
ごちそう	ご馳走
こち	鯒
こち	故知
ごだんかつよう	五段活用
こだわ	拘
ごたようちゅう	御多用中
ごたようちゅう	ご多用中
ごたぼう	御多忙
ごたぼう	ご多忙
ごだつ	誤脱
こたつ	炬燵
こだち	木立
ごたしょう	御多祥
ごたしょう	ご多祥
ごたく	御託
こだか	小高
こたえ	答え
こたえ	答
こたえ	堪え
こたえ	応え
こたいさ	個体差
こだい	古代
こたい	固体
こたい	個体
ごぞんじ	御存知
ごぞんじ	ご存知
ごぞんじ	ご存じ
こそだて	子育て
ごそくろう	御足労
ごそくろう	ご足労
こそく	姑息
ごそうふ	御送付
ごそうふ	ご送付
ごそうだん	御相談
ごそうだん	ご相談
ごそうさ	誤操作
ごそう	護送
ごそう	誤想
こぞう	小僧
ごせんふ	五線譜
ごせんぞ	御先祖
ごせんぞ	ご先祖
ごせんし	五線紙
こせんきょう	跨線橋
ごぜん	御前
ごぜん	午前
ごせん	互選
こせん	古銭
こぜに	小銭
こぜつ	孤絶
こせき	戸籍
こせき	古跡
ごせいらん	御清覧
ごせいだい	御盛大
ごせいだい	ご盛大
ごせいしょう	御清祥
ごせいしょう	御清勝
ごせいしょう	ご清祥
ごせいしょう	ご清勝
ごせいぎょう	御盛業
ごせいぎょう	ご盛業
ごせいきゅう	御請求
ごせいきゅう	ご請求
ごせいえい	御清栄
ごせいえい	ご清栄
ごせいうん	御盛運
ごせいうん	ご盛運
ごせい	悟性
こせい	個性
こすっから	こすっ辛
こずえ	梢
ごすう	語数
こすう	戸数
こすう	個数
こすい	湖水
こす	擦
ごじん	御仁
ごしん	護身
ごしん	誤診
ごしん	誤信
こじん	故人
こじん	個人
ごしょく	誤植
ごしょうち	御承知
ごしょうち	ご承知
ごしょうたい	御招待
ごしょうたい	ご招待
ごしょうかい	御紹介
ごしょうかい	御照会
ごしょうかい	ご紹介
ごしょうかい	ご照会
ごじょう	互譲
ごしよう	御使用
ごしよう	ご使用
ごしょう	後生
こじょう	古城
こしょう	胡椒
こしょう	湖沼
こしょう	故障
こしょう	呼称
ごじょ	互助
ごしょ	御所
こしょ	古書
ごじゅん	語順
ごじゅっぽひゃっぽ	五十歩百歩
ごしゅっせき	御出席
ごしゅっせき	ご出席
ごしゅじん	御主人
ごしゅじん	ご主人
ごしゅうにん	御就任
ごしゅうにん	ご就任
こじゅうと	小姑
ごじゅうしょ	御住所
ごじゅうしょ	ご住所
ごじゅうおん	五十音
ごじゅう	五重
こしゅう	固執
こじゅ	古樹
こしゅ	戸主
こしゅ	固守
ごしゃく	語釈
こしゃく	小癪
ごしゃ	誤射
こじま	小島
こしぬけ	腰抜け
ごしどう	御指導
ごしどう	ご指導
ごしつもん	御質問
ごしつもん	ご質問
ごじつ	後日
こしつ	固執
こしつ	個室
こしたんたん	虎視眈々
こじき	乞食
こしき	甑
こしき	古式
こしかけ	腰掛け
こしかけ	腰かけ
ごしえん	御支援
ごしえん	ご支援
こじあけ	こじ開け
ごじあい	御自愛
ごじあい	ご自愛
ごじ	護持
ごじ	誤字
ごし	腰
ごし	越し
こじ	誇示
こじ	故事
こじ	孤児
こじ	固辞
こじ	固持
こじ	古寺
こじ	居士
こし	輿
こし	腰
こし	枯死
ごさんれつ	御参列
ごさんれつ	ご参列
ごさんか	御参加
ごさんか	ご参加
こさん	古参
こさめ	小雨
こさつ	古刹
こざかし	小賢し
こざいく	小細工
ごさい	後妻
ごさ	誤差
ごこんせつ	御懇切
ごこんせつ	ご懇切
ごこんじょう	御懇情
ごこんじょう	ご懇情
ここん	古今
こころよ	快
こころゆ	心行
こころもとな	心許な
こころもち	心持ち
こころみ	試み
こころまち	心待ち
こころぼそ	心細
こころのこり	心残り
こころね	心根
こころない	心ない
こころな	心無
こころづよ	心強
こころづけ	心付け
こころざし	志
こころから	心から
こころがまえ	心構え
こころがけ	心掛け
こころがけ	心がけ
こころえ	心得
こころいき	心意気
こころある	心ある
こころ	心
ここのつ	九つ
ここのそじ	九十路
ここのか	九日
ここのか	9日
ここのか	９日
こごと	小言
ここちよ	心地よ
ごこち	心地
ここち	心地
ここじん	個々人
ごこく	護国
ごこく	五穀
ここく	故国
こごえ	凍え
ごこうらん	御高覧
ごこうらん	ご高覧
ごこうはい	御高配
ごこうはい	ご高配
ごこうじょう	御厚情
ごこうじょう	ご厚情
ごこうし	御厚志
ごこうし	ご厚志
ごこうぎ	御高誼
ごこうぎ	ご高誼
ごこうい	御好意
ごこうい	御厚意
ごこうい	ご好意
ごこうい	ご厚意
ごこう	後光
ごご	午后
ごご	午後
こご	古語
ここ	個々
ごけんとう	御検討
ごけんとう	ご検討
ごけんしょう	御健勝
ごけんしょう	ご健勝
ごげん	語源
ごけん	護憲
ごけっせき	御欠席
ごけっせき	ご欠席
ごけっこん	御結婚
ごけっこん	ご結婚
こげつ	焦げ付
ごけい	互恵
こけい	固形
ごけ	後家
こげ	焦げ
こけ	苔
こくろん	国論
ごくろうさま	御苦労様
ごくろうさま	ご苦労さま
ごくろう	御苦労
ごくろう	ご苦労
こくれん	国連
こくるい	穀類
こくりつ	国立
ごくらく	極楽
こくようせき	黒曜石
こくゆう	国有
こくもつ	穀物
こくめい	国名
こくめい	克明
こくむ	国務
こくみんかいへい	国民皆兵
こくみん	国民
こぐま	子熊
こくぼうそうしょう	国防総省
こくぼう	国防
こくほう	国宝
こくほ	国保
こくべつ	告別
こくふく	克服
ごくひん	極貧
こくひん	国賓
こくひょう	酷評
ごくひ	極秘
こくひ	国費
こくばん	黒板
こくはつ	告発
こくはく	酷薄
こくはく	告白
こくないせん	国内線
こくない	国内
こくどう	国道
こくど	国土
こくでん	国電
こくてい	国定
こぐち	小口
こくち	告知
こくだか	石高
こくだい	国大
こくそ	告訴
こくせん	国選
こくせき	国籍
こくぜい	国税
こくせい	国政
こくせい	国勢
こくじん	黒人
こくじょく	国辱
ごくじょう	極上
こくじょう	国情
こくしょ	酷暑
こくしょ	国書
ごくしゃ	獄舎
こくしむそう	国士無双
こくじ	酷似
こくじ	国璽
こくじ	国事
こくじ	告示
こくし	酷使
こくし	国史
こくさんしゃ	国産車
こくさん	国産
こくさく	国策
こくさいせん	国際線
こくさいか	国際化
こくさい	国際
こくさい	国債
こくご	国語
こくこ	国庫
こくぎ	国技
こくがい	国外
こくおう	国王
こくえき	国益
こくえい	国営
こくう	穀雨
こくう	虚空
こくいん	刻印
ごくい	極意
こくい	国威
ごくあく	極悪
ごく	語句
ごく	極
こく	酷
こく	刻
ごきょうりょく	御協力
ごきょうりょく	ご協力
ごぎょう	五行
こきょう	故郷
こきゅう	胡弓
こきゅう	呼吸
こきゃく	顧客
こぎみよ	小気味よ
ごきぼう	御希望
ごきぼう	ご希望
ごきにゅう	御記入
ごきにゅう	ご記入
こぎって	小切手
こきつか	こき使
こぎつ	こぎ着
ごきたい	御期待
ごきたい	ご期待
こきざみ	小刻み
ごきげん	ご機嫌
ごき	誤記
ごき	語気
こき	子機
こき	呼気
こき	古稀
こき	古希
ごかんよう	御寛容
ごかんよう	ご寛容
ごかんづき	ご感づき
ごかんづき	ご勘づき
ごかんせい	互換性
ごかんじょ	御寛恕
ごかんじょ	ご寛恕
ごかんき	互換機
ごがん	護岸
ごかん	語感
ごかん	語幹
ごかん	互換
こがらし	木枯し
こがら	小柄
こがね	黄金
ごかてい	御家庭
ごかてい	ご家庭
ごかつやく	御活躍
ごかつやく	ご活躍
こかつ	枯渇
こがたき	小型機
こがた	小形
こがた	小型
ごかぞく	御家族
ごかぞく	ご家族
こかげ	木陰
ごかくにん	御確認
ごかくにん	ご確認
ごがく	語学
ごかいとう	御回答
ごかいとう	ご回答
ごかいそう	御会葬
ごかいそう	ご会葬
こがいしゃ	子会社
ごかい	誤解
こがい	戸外
こが	焦が
こか	固化
ごおんこ	御恩顧
ごおんこ	ご恩顧
こおりつ	凍り付
こおりざとう	氷砂糖
こおり	氷
こおり	郡
こーひー	珈琲
こおとこ	小男
ごおうぼ	御応募
ごおうぼ	ご応募
こおう	呼応
こお	氷
こお	凍
ごえんじょ	御援助
ごえんじょ	ご援助
ごえつどうしゅう	呉越同舟
こえだ	小枝
こえがわり	声変わり
こえがわり	声変り
ごえいてん	御栄転
ごえいてん	ご栄転
ごえい	護衛
こえ	肥え
こえ	肥
こえ	超え
こえ	声
こえ	越え
ごうわん	剛腕
こうわん	港湾
こうわ	講話
こうわ	講和
こうろん	口論
こうろん	公論
こうろう	功労
こうろ	高炉
こうろ	香炉
こうろ	航路
こうれつ	後列
ごうれい	号令
こうれい	高齢
こうれい	恒例
こうれい	好例
こうれい	交霊
こうりん	降臨
こうりょく	抗力
こうりょく	効力
こうりょう	香料
こうりょう	講料
こうりょう	荒涼
こうりょう	稿料
こうりょ	考慮
ごうりゅう	合流
こうりゅう	拘留
こうりゅう	交流
こうりゅう	興隆
こうりゃく	攻略
こうりゃく	後略
こうりつか	効率化
こうりつ	高率
こうりつ	効率
こうりつ	公立
ごうりき	強力
ごうり	合理
こうり	小売
こうり	高利
こうり	行李
こうり	功利
こうらん	高覧
こうらん	撹乱
こうらく	行楽
こうら	甲羅
ごうよく	強欲
こうよう	高揚
こうよう	紅葉
こうよう	昂揚
こうよう	効用
こうよう	公用
こうゆう	公有
こうゆう	交遊
こうゆう	交友
こうやく	膏薬
こうやく	口約
こうやく	公約
こうや	荒野
こうや	広野
ごうもん	拷問
こうもん	肛門
こうもん	校門
こうもり	蝙蝠
こうもくすう	項目数
こうもく	項目
ごうもう	剛毛
ごうも	毫も
こうめいせいだい	公明正大
ごうめいがいしゃ	合名会社
ごうめい	合名
こうめい	高名
こうめい	公明
こうむてん	工務店
こうむいん	公務員
こうむ	被
こうむ	公務
こうみんかん	公民館
こうみん	公民
こうみょう	巧妙
こうみゃく	鉱脈
こうみつ	高密
こうみ	香味
ごうまん	傲慢
ごうまん	ごう慢
こうまん	高慢
こうまい	高邁
こうぼく	高木
こうぼく	公僕
ごうほうらいらく	豪放磊落
ごうほう	豪放
ごうほう	合法
ごうほう	号砲
こうぼう	攻防
こうぼう	工房
こうぼう	好防
こうぼう	興亡
こうほう	航法
こうほう	広報
こうほう	工法
こうほう	公報
こうほう	後方
こうぼ	酵母
こうぼ	公募
こうほ	候補
ごうべん	合弁
こうべん	抗弁
こうへん	後編
こうへい	公平
こうぶんしょ	公文書
こうふん	興奮
こうぶつ	鉱物
こうぶつ	好物
こうふく	降伏
こうふく	幸福
こうふう	校風
こうぶ	後部
こうふ	公布
こうふ	交付
こうひん	公賓
こうひょう	講評
こうひょう	好評
こうひょう	公表
ごうひつ	合筆
こうひつ	硬筆
ごうひ	合否
こうび	交尾
こうび	後尾
こうひ	工費
こうひ	公費
こうはんい	広範囲
ごうはん	合板
こうばん	交番
こうはん	広範
こうはん	公判
こうはん	後半
こうはん	撹拌
ごうはら	業腹
こうばし	香ばし
こうはく	紅白
こうばい	購買
こうばい	紅梅
こうばい	勾配
こうはい	高配
こうはい	荒廃
こうはい	後輩
こうば	工場
こうは	硬派
こうは	光波
こうのう	効能
こうねんき	更年期
こうねん	高年
こうねん	後年
こうねつ	高熱
こうねつ	光熱
こうにん	公認
こうにん	後任
こうにゅう	購入
こうなん	硬軟
こうないえん	口内炎
こうない	港内
こうない	構内
こうない	校内
こうどく	購読
こうとく	公徳
こうとうむけい	荒唐無稽
こうとうぶ	後頭部
こうとうしき	恒等式
ごうどう	合同
ごうとう	強盗
こうどう	講堂
こうどう	行動
こうどう	坑道
こうどう	公道
こうどう	黄道
こうとう	高騰
こうとう	高等
こうとう	江東
こうとう	恒等
こうとう	喉頭
こうとう	口頭
こうど	高度
こうど	黄土
こうでん	香典
こうてん	好転
こうてん	好天
こうてん	公転
こうてん	交点
こうてん	後天
こうてつ	鋼鉄
こうてつ	更迭
こうてきしゅ	好敵手
こうてき	好適
こうてき	公的
こうでい	拘泥
こうてい	高低
こうてい	行程
こうてい	肯定
こうてい	皇帝
こうてい	校訂
こうてい	校庭
こうてい	工程
こうてい	公邸
こうてい	公定
こうつごう	好都合
ごうつくばり	業つくばり
こうつうもう	交通網
こうつうきかん	交通機関
こうつう	交通
こうちん	工賃
ごうちょく	剛直
こうちょく	硬直
こうちょうは	高調波
こうちょうかい	公聴会
こうちょう	高潮
こうちょう	紅潮
こうちょう	校長
こうちょう	好調
こうちゃく	膠着
こうちゃく	降着
こうちゃ	紅茶
こうちく	構築
こうち	耕地
こうち	拘置
こうち	巧遅
こうだんし	好男子
ごうたん	豪胆
ごうたん	剛胆
こうだん	講談
こうだん	講壇
こうだん	公団
こうだん	後段
こうたん	降誕
こうたん	後端
ごうだつ	強奪
こうたく	光沢
こうたいし	皇太子
こうたいごう	皇太后
ごうたい	剛体
こうだい	広大
こうたい	交代
こうたい	交替
こうたい	後退
こうた	小歌
こうた	小唄
こうそつ	高卒
こうそしん	控訴審
ごうぞく	豪族
こうぞく	皇族
こうぞく	後続
こうそく	高速
こうそく	梗塞
こうそく	校則
こうそく	拘束
こうそく	光速
こうぞうか	構造化
こうぞう	構造
こうそう	高層
こうそう	高僧
こうそう	降霜
こうそう	構想
こうそう	抗争
こうそう	広壮
こうそう	後送
ごうそ	強訴
こうぞ	楮
こうそ	酵素
こうそ	控訴
こうそ	公訴
こうせんてき	好戦的
こうぜん	公然
こうせん	高専
こうせん	鉱泉
こうせん	公選
こうせん	光線
こうせん	交戦
ごうせつ	豪雪
こうせつ	降雪
こうせつ	巧拙
こうせき	鉱石
こうせき	功績
こうせいのう	高性能
こうせいせき	好成績
こうせいいん	構成員
ごうせい	豪勢
ごうせい	合成
ごうせい	剛性
こうせい	硬性
こうせい	構成
こうせい	校生
こうせい	校正
こうせい	更生
こうせい	更正
こうせい	攻勢
こうせい	抗生
こうせい	恒星
こうせい	向性
こうせい	厚生
こうせい	公正
こうせい	後生
こうせい	後世
こうずか	好事家
ごうすう	号数
こうすう	工数
こうすいじゅん	高水準
こうずい	洪水
こうすい	香水
こうすい	降水
こうすい	硬水
こうず	構図
こうしんりょう	香辛料
こうしんらい	高信頼
こうしんじょ	興信所
こうじん	幸甚
こうじん	後塵
こうしん	高進
こうしん	行進
こうしん	更新
こうしん	交信
こうしん	後進
こうじろう	孝二郎
こうしょく	好色
こうしょく	公職
こうしょく	交織
こうじょうせん	甲状腺
ごうじょう	強情
ごうしょう	豪商
こうじょう	恒常
こうじょう	工場
こうじょう	向上
こうじょう	口上
こうじょう	厚情
こうしょう	哄笑
こうしょう	高尚
こうしょう	考証
こうしょう	校章
こうしょう	工厰
こうしょう	工廠
こうしょう	好尚
こうしょう	公証
こうしょう	公称
こうしょう	交渉
こうじょ	控除
こうじょ	公序
こうしょ	高所
こうしょ	向暑
こうじゅん	公準
こうじゅつ	講述
こうじゅつ	口述
こうじゅつ	後述
こうしゅうでんわ	公衆電話
こうしゅうかい	講習会
こうしゅう	講習
こうしゅう	口臭
こうしゅう	公衆
こうじゅ	口授
こうしゅ	攻守
こうしゃく	講釈
こうしゃく	公爵
こうしゃく	候爵
ごうしゃ	豪奢
こうしゃ	降車
こうしゃ	校舎
こうしゃ	公社
こうしゃ	後者
こうしど	格子戸
こうじつ	口実
こうしつ	硬質
こうしつ	皇室
こうしき	硬式
こうしき	公式
ごうしがいしゃ	合資会社
ごうじ	合字
ごうし	合資
こうじ	糀
こうじ	小路
こうじ	麹
こうじ	高次
こうじ	工事
こうじ	公示
こうし	仔牛
こうし	講師
こうし	行使
こうし	皇子
こうし	厚志
こうし	公私
こうし	公司
こうし	公使
こうし	格子
こうざん	高山
こうざん	鉱山
こうさん	降参
こうさん	鉱産
こうさん	公算
こうさつ	高札
こうさつ	高察
こうさつ	考察
こうさつ	絞殺
こうさく	鋼索
こうさく	耕作
こうさく	工作
こうさく	交錯
こうざい	鋼材
こうさい	虹彩
こうさい	高裁
こうさい	公債
こうさい	交際
こうざ	講座
こうざ	口座
こうさ	考査
こうさ	公差
こうさ	交差
こうさ	較差
こうさ	黄砂
こうこつ	恍惚
こうこつ	硬骨
こうこく	広告
こうこく	公国
こうこく	公告
こうごうせい	光合成
こうこうせい	高校生
こうごうし	神々し
ごうごう	轟々
こうごう	皇后
こうこう	煌々
こうこう	高校
こうこう	航行
こうこう	膏肓
こうこう	孝行
こうこう	後攻
ごうご	豪語
こうご	口語
こうご	交互
こうこ	考古
こうこ	江湖
こうこ	公庫
こうげんびょう	膠原病
ごうけん	剛健
こうげん	高原
こうげん	公言
こうげん	光源
こうけん	貢献
こうけん	後見
こうけつあつ	高血圧
ごうけつ	豪傑
こうけつ	高潔
こうげき	攻撃
ごうけい	合計
こうげい	工芸
こうけい	口径
こうけい	光景
こうけい	後継
こうぐん	行軍
こうくうけん	航空券
こうくうき	航空機
こうぐう	皇宮
こうくう	高空
こうくう	航空
こうぐ	工具
こうく	校区
こうきんり	高金利
ごうきん	合金
こうきん	拘禁
こうきん	公金
こうきょうぶつ	公共物
こうきょうきょく	交響曲
こうきょうがく	交響楽
こうぎょう	鉱業
こうぎょう	工業
こうぎょう	興行
こうぎょう	興業
こうきょう	広狭
こうきょう	好況
こうきょう	公共
こうきょう	交響
こうきょ	薨去
こうきょ	皇居
ごうきゅう	号泣
こうきゅう	高給
こうきゅう	高級
こうきゅう	講究
こうきゅう	硬球
こうきゅう	恒久
こうきゅう	公休
こうきゅう	後宮
こうきしん	好奇心
ごうぎ	豪儀
ごうぎ	合議
ごうき	剛毅
こうぎ	高誼
こうぎ	講義
こうぎ	抗議
こうぎ	広義
こうき	高貴
こうき	広軌
こうき	工期
こうき	好機
こうき	好奇
こうき	後記
こうき	後期
こうがんむち	厚顔無恥
こうかんき	交換機
こうかんき	交換器
ごうかん	強姦
こうがん	睾丸
こうがん	紅顔
こうがん	厚顔
こうかん	高官
こうかん	鋼管
こうかん	好感
こうかん	交歓
こうかん	交換
こうかん	交感
こうかふこうか	幸か不幸か
こうがっか	工学科
こうかつ	狡猾
こうがくぶ	工学部
こうがくねん	高学年
ごうかく	合格
こうがく	高額
こうがく	工学
こうがく	向学
こうがく	光学
こうがく	後学
こうかく	降格
こうかく	甲殻
こうかく	広角
こうかがく	光化学
こうかいどう	公会堂
ごうがい	号外
ごうかい	豪快
こうがい	慷慨
こうがい	郊外
こうがい	構外
こうがい	梗概
こうがい	校外
こうがい	口外
こうがい	公害
こうかい	航海
こうかい	更改
こうかい	公開
こうかい	公海
こうかい	後悔
ごうか	豪華
こうが	高雅
こうか	高架
こうか	高価
こうか	降下
こうか	考課
こうか	硬貨
こうか	硬化
こうか	校歌
こうか	工科
こうか	効果
こうおん	高音
こうおん	高温
こうおん	恒温
こうおつ	甲乙
こうえん	講演
こうえん	好演
こうえん	公演
こうえん	公園
こうえん	後援
こうえつ	校閲
こうえき	公役
こうえき	公益
こうえき	交易
こうえい	公営
こうえい	光栄
こうえい	後衛
こううんき	耕耘機
こううん	幸運
こううん	好運
ごうう	豪雨
こうう	降雨
ごういん	強引
こういん	行員
こういん	荒淫
こういん	拘引
こういん	工員
こういん	公印
こういん	光陰
こういってん	紅一点
こういしょう	後遺症
こういき	広域
ごうい	合意
こうい	高位
こうい	行為
こうい	校医
こうい	更衣
こうい	好意
こうい	厚意
こうあん	考案
こうあん	公安
こうあつ	高圧
ごう	豪
ごう	合
ごう	号
ごう	剛
ごう	業
こう	頁
こう	高
こう	項
こう	講
こう	航
こう	稿
こう	甲
こう	港
こう	校
こう	昂
こう	抗
こう	孔
こう	口
こう	功
こう	光
こう	候
ごいらい	御依頼
ごいらい	ご依頼
こいぶみ	恋文
こいびと	恋人
こいぬ	仔犬
ごいっぽう	御一報
ごいっとうさま	御一統様
ごいっしょ	御一緒
ごいっしょ	ご一緒
ごいちどうさま	御一同様
こいじ	恋路
こいし	恋し
こいし	小石
こいけ	小池
ごい	語彙
ごい	語意
こい	恋
こい	請い
こい	鯉
こい	故意
ごあんない	御案内
ごあんない	ご案内
ごあいよう	御愛用
ごあいよう	ご愛用
ごあいさつ	御挨拶
ごあいさつ	ご挨拶
ごあいこ	御愛顧
ごあいこ	ご愛顧
ご	語
ご	碁
ご	伍
ご	五
こ	恋
こ	娘
こ	粉
こ	濃
こ	超
こ	漕
こ	請
こ	小
こ	子
こ	混
こ	込
こ	漉
こ	乞
こ	鼓
こ	戸
こ	弧
こ	呼
こ	個
こ	凝
こ	越
げんわく	眩惑
げんわく	幻惑
げんろん	言論
げんろん	原論
げんろく	元禄
けんろう	堅牢
けんりょく	権力
げんりょうし	限量子
げんりょう	減量
げんりょう	原料
けんりょう	見料
げんりゅう	源流
けんりつ	県立
げんり	原理
けんり	権利
げんよう	現用
けんよう	兼用
げんゆう	現有
げんゆ	原油
けんやく	倹約
げんや	原野
けんもん	検問
げんめん	減免
げんめつ	幻滅
げんめい	言明
げんめい	厳命
けんめい	賢明
けんめい	懸命
けんめい	件名
けんむ	兼務
けんみん	県民
げんみつ	厳密
げんまい	玄米
けんま	研磨
げんぽん	原本
けんぽん	献本
げんぼく	原木
けんぼうしょう	健忘症
げんぽう	減俸
けんぽう	拳法
けんぽう	憲法
げんぼ	原簿
けんぽ	健保
けんべん	検便
けんぺいりつ	建蔽率
けんぺい	権柄
けんぺい	憲兵
げんぶん	原文
けんぶん	見聞
けんぶん	検分
げんぶつ	現物
けんぶつ	見物
げんぶがん	玄武岩
げんぷう	厳封
げんぷ	厳父
けんぷ	絹布
げんぴん	現品
けんびきょう	顕微鏡
げんぴ	厳秘
けんび	兼備
げんばん	原盤
けんばん	鍵盤
げんぱつ	原発
げんばつ	厳罰
げんばく	原爆
けんばいき	券売機
げんぱい	減配
げんば	現場
けんのん	剣呑
げんのう	玄能
けんのう	献納
けんのう	権能
げんにん	現任
けんにん	兼任
けんにょう	検尿
げんに	現に
けんなん	険難
けんない	県内
けんない	圏内
けんどちょうらい	捲土重来
けんとし	ケント紙
げんどうりょく	原動力
げんどうき	原動機
けんとうかい	検討会
げんどう	言動
げんどう	原動
げんとう	幻灯
げんとう	厳冬
けんどう	県道
けんどう	剣道
けんとう	見当
けんとう	検討
けんとう	健闘
げんど	限度
げんてん	減点
げんてん	原点
げんてん	原典
けんでん	喧伝
げんていばん	限定版
げんてい	限定
けんてい	献呈
けんてい	検定
げんつき	原付
げんちょう	幻聴
けんちょう	県庁
けんちょう	健聴
げんちょ	原著
けんちょ	顕著
けんちくし	建築士
けんちく	建築
げんち	言質
げんち	現地
けんち	見地
けんち	検知
げんたん	減反
けんたん	健啖
げんたつ	厳達
げんだいじん	現代人
けんたいき	倦怠期
けんたいかん	倦怠感
げんだい	現代
げんだい	原題
げんたい	減退
けんたい	倦怠
げんぞん	現存
げんそん	現存
げんそん	減損
けんそん	謙遜
げんぞく	還俗
げんそく	減速
げんそく	原則
けんぞく	眷族
けんぞうぶつ	建造物
げんぞう	現像
げんそう	現送
げんそう	幻想
けんぞう	建造
けんそう	喧躁
けんそう	喧騒
げんそ	元素
けんそ	険阻
けんそ	倹素
げんぜん	厳然
げんせん	源泉
げんせん	厳選
けんぜん	健全
けんせん	健羨
げんせつ	言説
けんせつ	建設
げんせき	原石
げんぜい	減税
げんせい	厳正
けんせい	県政
けんせい	牽制
けんせい	権勢
げんせ	現世
げんすん	原寸
げんすう	減数
けんすう	軒数
けんすう	件数
げんすいばく	原水爆
げんすい	減衰
げんすい	減水
げんすい	元帥
けんすい	懸垂
げんず	原図
けんじん	賢人
けんじん	県人
けんしん	献身
けんしん	検針
けんしん	検診
げんしろ	原子炉
げんしりょく	原子力
げんしょく	現職
げんしょく	減食
げんしょく	原色
けんしょく	兼職
げんじょう	現状
げんじょう	原状
げんしょう	現象
げんしょう	減少
けんじょう	謙譲
けんじょう	献上
けんしょう	肩章
けんしょう	検証
けんしょう	懸賞
けんしょう	憲章
けんしょう	健勝
げんしょ	原書
げんしょ	原初
けんしゅつ	検出
げんしゅく	厳粛
げんじゅうみん	原住民
げんじゅうしょ	現住所
げんじゅう	厳重
げんしゅう	減収
けんじゅう	拳銃
けんしゅう	研修
けんしゅう	検収
げんしゅ	厳守
げんしゅ	原酒
げんしゅ	原種
げんしゅ	元首
けんしゅ	券種
けんじゃ	賢者
げんじてん	現時点
げんじつみ	現実味
げんじつ	現実
けんじつ	堅実
けんしき	見識
げんしかく	原子核
げんじ	現示
げんじ	源氏
げんし	減資
げんし	幻視
げんし	原紙
げんし	原子
げんし	原始
けんじ	顕示
けんじ	献辞
けんじ	検事
けんじ	堅持
けんじ	健児
けんし	犬歯
けんし	検視
けんし	検死
げんさんち	原産地
げんざん	減算
げんさん	減産
げんさん	原産
けんざん	検算
けんさつかん	検察官
けんさつ	賢察
けんさつ	検札
けんさつ	検察
げんさく	原作
けんさく	研削
けんさく	献策
けんさく	検索
げんざいりょう	原材料
げんざい	現在
げんざい	原罪
げんさい	減殺
けんざい	顕在
けんざい	建材
けんざい	健在
けんさ	検査
げんこく	原告
けんこく	建国
けんこうほけん	健康保険
げんこうはん	現行犯
けんこうこつ	肩甲骨
げんごう	元号
げんこう	言行
げんこう	現行
げんこう	原稿
けんごう	剣豪
けんこう	軒昂
けんこう	健康
げんご	言語
げんご	原語
けんご	堅固
けんげん	顕現
けんげん	権限
けんけつ	献血
げんけい	減刑
げんけい	原形
げんけい	原型
けんけい	県警
げんきん	現金
げんきん	厳禁
けんきん	献金
げんぎょう	現業
げんきょう	現況
げんきょう	元凶
けんぎょう	兼業
けんきょ	謙虚
けんきょ	検挙
けんきゅうじょ	研究所
けんきゅうしつ	研究室
けんきゅうかい	研究会
げんきゅう	言及
げんきゅう	減給
けんきゅう	研究
げんきゃく	減却
けんきゃく	健脚
げんき	元気
けんぎ	県議
けんぎ	建議
けんぎ	嫌疑
げんかん	玄関
げんかん	厳寒
けんがん	検眼
げんかしょうきゃく	減価償却
けんかごし	喧嘩腰
げんがく	衒学
げんがく	減額
げんがく	弦楽
げんかく	幻覚
げんかく	厳格
けんがく	見学
けんかく	懸隔
げんかいち	限界値
げんがい	言外
げんかい	限界
げんかい	厳戒
けんがい	県外
けんがい	懸崖
けんがい	圏外
けんかい	見解
けんかい	県会
げんが	原画
げんか	言下
げんか	現下
げんか	減価
げんか	原価
けんか	県下
けんか	喧嘩
けんおん	検温
けんお	嫌悪
けんえん	犬猿
けんえん	嫌煙
けんえつ	検閲
げんえき	現役
げんえき	減益
げんえき	原液
けんえき	検疫
げんえい	幻影
けんえい	県営
けんえい	兼営
げんいん	原因
けんいん	牽引
けんいん	検印
けんい	権威
げんあん	原案
けんあん	検案
けんあん	懸案
げんあつ	減圧
けんあく	険悪
げん	言
げん	現
げん	玄
げん	減
げん	弦
けん	腱
けん	験
けん	軒
けん	賢
けん	県
けん	献
けん	検
けん	剣
けん	券
けん	健
けん	件
けわし	険し
げれつ	下劣
げりゃく	下略
げり	下痢
げらく	下落
けらい	家来
けやき	欅
けもの	獣
けむり	煙
けむた	煙た
けむし	毛虫
けむ	煙
げぼく	下僕
けぶか	毛深
げひん	下品
けびょう	仮病
げびた	下卑た
けはい	気配
げば	下馬
けねん	懸念
げねつざい	解熱剤
げねつ	解熱
けなみ	毛並
けなげ	健気
けな	貶
けとば	蹴飛ば
げどく	解毒
けつろん	結論
けつろ	結露
けつれつ	決裂
げつれい	月齢
げつれい	月例
けつれい	欠礼
けつりゅう	血流
げつり	月利
けつらく	欠落
げつようび	月曜日
げつよう	月曜
けつめい	結盟
けつみゃく	血脈
げつまつ	月末
けつまづ	蹴つまづ
けつまつ	結末
けつまくえん	結膜炎
げっぽう	月報
げっぽう	月俸
けつぼう	欠乏
けつべつ	訣別
けつべつ	決別
けっぺき	潔癖
げっぺい	月餅
げっぷ	月賦
けつばん	欠番
けっぱく	潔白
けっとば	蹴っ飛ば
けっとう	血統
けっとう	血糖
けっとう	結党
けっとう	決闘
けってん	欠点
けってい	決定
けっちん	血沈
けっちゃく	決着
けつだん	結団
けつだん	決断
けったく	結託
けっそん	欠損
けつぞく	血族
けっそく	結束
けっそう	血相
けっせん	血栓
けっせん	結線
けっせん	決戦
けっせき	結石
けっせき	欠席
けっせい	血清
けっせい	結成
けっしん	結審
けっしん	決心
げっしょく	月食
けっしょく	血色
けっしょく	欠食
けっしょうばん	血小板
けっしょうせん	決勝戦
けつじょう	欠場
けっしょう	結晶
けっしょう	決勝
けつじょ	欠如
けっしゅつ	傑出
げっしゅう	月収
けっしゅう	結集
げっしゃ	月謝
けっしゃ	結社
けっして	決して
けつじつ	結実
げつじ	月次
けっし	決死
げっさん	月産
けっさん	決算
けっさく	傑作
けっさい	決裁
けっさい	決済
けっこんしき	結婚式
けっこん	血痕
けっこん	結婚
げっこう	月光
げっこう	激昂
けつごう	結合
けっこう	血行
けっこう	結構
けっこう	決行
けっこう	欠航
けつげん	結言
げっけいじゅ	月桂樹
げっけい	月経
けっきん	欠勤
けっきょく	結局
げっきゅう	月給
けっきゅう	血球
けつぎ	決議
けっき	決起
げっかん	月間
げっかん	月刊
けっかん	血管
けっかん	欠陥
げつがく	月額
けっかく	結核
けっかく	欠格
けっかい	結界
けっかい	決壊
げっか	月下
けっか	結果
けっか	欠課
けつえん	血縁
けつえきがた	血液型
けつえき	血液
けついん	欠員
けつい	決意
けつあつ	血圧
けつ	決
けっ	決
げだん	下段
げたばこ	下駄箱
げだつ	解脱
けたちがい	桁違い
けだか	気高
げた	下駄
けた	桁
げそくばん	下足番
げそくばこ	下足箱
げそく	下足
けそう	懸想
げせん	下賎
げせん	下船
けずりと	削り取
げすいどう	下水道
げすい	下水
けず	削
けしん	化身
けしょうひん	化粧品
けしょう	化粧
げじゅん	下旬
げしゅく	下宿
げしゃ	下車
けしとめ	消し止め
けしごむ	消しゴム
けしきば	気色ば
けしき	景色
けしき	気色
けしいん	消印
げし	夏至
けし	消し
けし	芥子
げざん	下山
げざい	下剤
けさ	今朝
けさ	袈裟
げこう	下校
げこ	下戸
げきろん	激論
げきれつ	激烈
げきれい	激励
げきりん	逆鱗
げきりゅう	激流
けぎらい	気嫌い
げきやく	劇薬
げきめつ	撃滅
げきむ	激務
げきへん	激変
げきはつ	激発
げきは	撃破
げきとつ	激突
げきどう	激動
げきとう	激闘
げきど	激怒
げきてき	劇的
げきつう	激痛
げきつい	撃墜
げきだん	劇団
げきたい	撃退
げきぞう	激増
げきせん	激戦
げきしん	激震
げきしん	撃針
げきしょく	激職
げきじょう	激情
げきじょう	劇場
げきしょ	激暑
げきさん	激賛
げきげん	激減
げきから	激辛
げきが	劇画
げきか	激化
げき	檄
げき	激
げき	劇
げかん	下巻
けがわ	毛皮
けがれ	汚れ
けがらわし	汚らわし
げかい	外界
げかい	外科医
げかい	下界
げか	外科
けが	怪我
けが	汚
けおりもの	毛織物
けおと	蹴落と
けいろう	敬老
けいろ	経路
けいれつ	系列
けいれき	経歴
けいれい	敬礼
けいるい	係累
けいりん	競輪
けいりょう	計量
けいりゅう	繋留
けいりゅう	渓流
けいりゅう	係留
けいりゃく	計略
けいり	経理
けいらん	鶏卵
けいようし	形容詞
けいよう	掲揚
けいよう	形容
けいよ	恵与
けいゆ	軽油
けいゆ	経由
けいやくしょ	契約書
けいやく	契約
けいもう	啓蒙
げいめい	芸名
けいむしょ	刑務所
けいみょう	軽妙
けいぼう	閨房
けいほう	警報
けいほう	刑法
けいべん	軽便
けいべつ	軽蔑
けいふく	敬服
けいぶ	軽侮
けいぶ	警部
けいふ	系譜
げいひんかん	迎賓館
げいひん	迎賓
けいひん	景品
けいび	軽微
けいび	警備
けいひ	経費
けいはんざい	軽犯罪
けいばつ	閨閥
けいばつ	刑罰
けいはつ	啓発
けいはく	軽薄
けいばい	競売
げいは	鯨波
けいば	競馬
げいのうじん	芸能人
げいのう	芸能
けいねん	経年
げいにん	芸人
けいとうじゅ	系統樹
げいとう	芸当
けいとう	系統
けいとう	傾倒
けいど	軽度
けいど	経度
けいと	毛糸
けいでんき	継電器
けいてき	警笛
けいてい	兄弟
けいちょうふはく	軽佻浮薄
けいちょう	軽重
けいちょう	慶弔
けいちょう	傾聴
けいちゅう	傾注
けいちつ	啓蟄
けいだい	境内
けいたい	携帯
けいたい	形態
けいそつ	軽率
けいぞく	継続
けいそく	計測
けいぞう	恵贈
けいそう	軽装
けいそう	形相
けいそう	係争
けいそ	硅素
けいせん	罫線
けいせん	経線
けいせつ	蛍雪
けいせき	形跡
けいせい	形成
けいせい	形勢
けいせい	傾城
けいすう	計数
けいすう	係数
けいすい	軽水
けいず	系図
けいしん	軽震
けいしょく	軽食
けいじょう	計上
けいじょう	経常
けいじょう	形状
けいじょう	啓上
けいしょう	軽症
けいしょう	軽傷
けいしょう	警鐘
けいしょう	継承
けいしょう	景勝
けいしょう	敬称
けいしょう	形象
げいしゅん	迎春
げいじゅつ	芸術
けいしゅつ	掲出
けいしゅく	慶祝
けいじゅう	軽重
げいしゃ	芸者
けいしゃ	傾斜
けいしつ	形質
けいじじょう	形而上
けいしき	形式
けいじ	掲示
けいじ	慶事
けいじ	刑事
けいし	軽視
けいし	警視
けいさんしょ	計算書
けいさんき	計算機
けいさん	計算
けいさん	珪酸
けいさつしょ	警察署
けいさつかん	警察官
けいさつ	警察
けいざいめん	経済面
けいざいかい	経済界
けいざい	経済
けいさい	掲載
げいごと	芸事
けいこく	警告
けいこく	渓谷
けいこうとう	蛍光灯
けいこうぎょう	軽工業
げいごう	迎合
けいごう	契合
けいこう	鶏口
けいこう	蛍光
けいこう	携行
けいこう	傾向
けいご	警護
けいご	敬語
けいこ	稽古
けいげん	軽減
けいけん	経験
けいけん	敬虔
げいげき	迎撃
けいけい	炯々
けいぐ	敬具
けいきんぞく	軽金属
けいきょもうどう	軽挙妄動
けいき	計器
けいき	景気
けいき	契機
けいき	刑期
けいがん	慧眼
けいかん	警官
けいかん	景観
けいかく	計画
けいがい	形骸
けいかい	軽快
けいかい	警戒
けいが	慶賀
けいか	経過
けいえん	敬遠
けいえい	経営
げいいんばしょく	鯨飲馬食
けいいん	契印
けいい	経緯
けいい	敬意
けいあい	敬愛
げい	芸
けい	計
けい	系
けい	桂
けい	敬
けい	慶
けい	啓
けい	刑
げ	下
け	毛
け	消
け	蹴
くんわ	訓話
くんれん	訓練
くんれい	訓令
くんりん	君臨
ぐんらく	群落
くんよみ	訓読み
ぐんよう	軍用
ぐんゆう	群雄
ぐんもう	群盲
くんぷう	薫風
ぐんぶ	郡部
ぐんぶ	軍部
ぐんぶ	群舞
ぐんび	軍備
ぐんぱつ	群発
ぐんばい	軍配
ぐんとう	群島
くんどう	訓導
くんとう	薫陶
ぐんだん	軍団
ぐんたい	軍隊
ぐんぞう	群像
ぐんそう	軍曹
ぐんせい	群生
くんせい	燻製
くんせい	薫製
ぐんじん	軍人
ぐんしん	軍神
ぐんしょう	群小
くんじょう	燻蒸
くんじょう	薫蒸
くんしょう	勲章
ぐんしゅく	軍縮
ぐんしゅう	群集
ぐんしゅう	群衆
ぐんじゅ	軍需
くんしゅ	暈酒
くんしゅ	君主
ぐんしきん	軍資金
ぐんじ	軍事
ぐんし	軍師
くんじ	訓示
ぐんこく	軍国
くんこく	訓告
ぐんこう	軍港
ぐんこう	軍功
ぐんきょ	群居
ぐんかん	軍艦
ぐんかく	軍拡
くんかい	訓戒
ぐんか	軍歌
くんいく	訓育
ぐんい	軍医
ぐん	郡
ぐん	軍
ぐん	群
くん	訓
くん	薫
くん	君
くわわ	加わ
くわり	区割り
くわだて	企て
くわし	詳し
くわけ	区分け
くわえ	加え
くわ	鍬
くわ	桑
くろやま	黒山
くろめ	黒目
くろまめ	黒豆
くろまく	黒幕
くろぼし	黒星
くろつち	黒土
くろず	黒ず
くろしお	黒潮
くろじ	黒字
くろざとう	黒砂糖
くろうと	玄人
ぐろう	愚弄
くろう	苦労
くろいし	黒石
くろ	黒
ぐれん	紅蓮
くれない	紅
くれ	暮れ
くるみ	胡桃
くるまだい	車代
くるま	車
くるしめ	苦しめ
ぐるし	苦し
くるし	苦し
くる	狂
くりょ	苦慮
くりやま	栗山
くりひろげ	繰り広げ
くりのべ	繰延
くりのべ	繰り延べ
くりつ	区立
くりだ	繰り出
くりさげ	繰り下げ
くりさが	繰り下が
くりごと	繰言
くりこし	繰越
くりこ	繰り込
くりこ	繰り越
くりかえし	繰返し
くりかえ	繰り返
くりいれ	繰り入れ
くりあげ	繰り上げ
くりあが	繰り上が
くり	栗
くらやみ	暗闇
くらべ	比べ
くらべ	較べ
くらぶ	倶楽部
くらげ	鮓
くらく	苦楽
くらがり	暗がり
くらがえ	鞍替え
くらいつ	食らいつ
くらい	位
くら	暮ら
くら	蔵
くら	倉
くら	食ら
くら	鞍
くら	暗
くよう	供養
くやし	悔し
くやくしょ	区役所
くや	悔や
ぐもん	愚問
くもん	苦悶
くもり	曇
くもら	曇ら
くもま	雲間
くもつ	供物
くも	曇
くも	蜘蛛
くも	雲
くめん	工面
くみん	区民
くみはん	組版
くみなお	組み直
くみと	汲み取
くみと	くみ取
くみつ	組み付
くみたて	組み立て
くみこ	組み込
くみかた	組み方
くみいれ	組み入れ
くみあわせ	組合せ
くみあわせ	組み合わせ
くみあわ	組み合わ
くみあげ	組み上げ
くみあげ	汲み上げ
くみあい	組合
くみあ	組み合
くみ	組
くまばち	熊蜂
ぐまい	愚昧
くま	熊
くぼ	窪
くべつ	区別
くぶん	区分
くぶくりん	九分九厘
くふう	工夫
くびわ	首輪
くびっぴき	首っ引き
くびったけ	首ったけ
くびすじ	首筋
ぐび	具備
くび	馘首
くび	首
くび	頚
くば	配
くのう	苦悩
くにぐに	国々
くにく	苦肉
くにがら	国柄
くに	国
くなん	苦難
くない	区内
ぐどん	愚鈍
くとうてん	句読点
ぐとう	愚答
くどう	駆動
くとう	苦闘
くど	口説
くてん	句点
くつわ	轡
くつろ	寛
くっぷく	屈服
くっぷく	屈伏
くつばこ	靴箱
くったく	屈託
くっせつ	屈折
くっせい	屈性
くっしん	屈伸
くつじょく	屈辱
くつじゅう	屈従
くつした	靴下
くっし	屈指
くっさく	掘削
くっきょく	屈曲
くっきょう	屈強
くつがえ	覆
くつう	苦痛
ぐつ	靴
くつ	靴
ぐちょく	愚直
くちょう	口調
くちょう	区長
くちゅう	駆虫
くちゅう	苦衷
くちもと	口元
くちべに	口紅
くちびる	唇
くちび	口火
くちはばった	口はばった
くちばし	嘴
くちばし	喙
くちばし	口走
くちづけ	口づけ
くちずさ	口ずさ
くちすう	口数
くちさがな	口さがな
くちぐるま	口車
くちぐせ	口癖
くちぐせ	口ぐせ
くちく	駆逐
くちがね	口金
くちかず	口数
くちえ	口絵
くちあたり	口当り
ぐち	愚痴
くち	口
くち	朽ち
くだん	件
くだらな	下らな
くだもの	果物
くださ	下さ
くだけ	砕け
ぐたいれい	具体例
ぐたいてき	具体的
ぐたいか	具体化
ぐたい	具体
くだ	砕
くだ	降
くだ	管
くだ	下
くそ	糞
くせん	苦戦
くせもの	曲者
くせつ	苦節
ぐせい	愚生
くせ	癖
くずれさ	崩れ去
くずれおち	崩れ落ち
くずれ	崩れ
くすりゆび	薬指
くすり	薬
くずもち	葛餅
くずてつ	屑鉄
ぐず	愚図
くず	崩
くず	屑
くず	葛
くす	楠
くす	樟
ぐしん	具申
くしん	苦心
くじらじゃく	鯨尺
くじら	鯀
くじら	鯨
ぐしょう	具象
くじょう	苦情
くしょう	苦笑
くじょ	駆除
くじゅう	苦渋
くしゅう	句集
くじゃく	孔雀
ぐしゃ	愚者
くじびき	くじ引き
くしくも	奇しくも
くし	櫛
くし	串
くし	駆使
くさわけ	草分け
くさり	鎖
くさもち	草餅
くさむら	叢
くさばな	草花
くさき	草木
くさかり	草刈り
くさ	腐
くさ	草
くさ	臭
ぐこう	愚考
くげん	苦言
くけい	矩形
くぐい	鵠
くぐ	潜
くく	括
くぎり	区切り
くぎり	句切り
くぎょう	公卿
くぎょう	苦行
くきょう	苦境
ぐきょ	愚挙
くぎづけ	釘付け
くぎ	釘
くぎ	区切
くき	茎
くかん	区間
くがく	苦学
くかく	区画
くおん	久遠
くえい	区営
くうろん	空論
くうろ	空路
くうれい	空冷
くうらん	空欄
くうゆ	空輸
くうほう	空砲
くうぼ	空母
くうふく	空腹
ぐうはつ	偶発
くうはく	空白
くうどう	空洞
くうてん	空転
くうちょう	空調
くうちゅう	空中
ぐうぞう	偶像
くうそう	空想
くうそ	空疎
ぐうぜん	偶然
くうぜん	空前
くうせき	空席
ぐうすう	偶数
くうしゅう	空襲
くうしゃ	空車
ぐうじ	宮司
くうじ	空自
くうこう	空港
くうこう	空孔
くうぐん	空軍
くうきょ	空虚
くうき	空気
くうかん	空間
ぐういん	偶因
くういき	空域
くうい	空位
ぐう	遇
ぐう	寓
くう	空
くいとめ	食い止め
くいつ	食いつ
くいちが	食い違
くいさが	食い下が
くいこ	食い込
くいき	区域
くいいじ	食い意地
くいい	食い入
くいあ	食い合
くい	杭
くい	悔い
ぐあい	具合い
ぐあい	具合
ぐ	愚
ぐ	具
く	組
く	食
く	酌
く	繰
く	喰
く	苦
く	区
く	句
く	九
く	汲
きんろう	勤労
きんりん	近隣
きんりょく	金力
きんりょく	筋力
きんりょう	禁猟
きんりょう	禁漁
きんり	金利
きんらい	近来
きんよく	金欲
きんよく	禁欲
きんようび	金曜日
きんよう	金曜
きんゆうぎょう	金融業
きんゆう	金融
きんゆ	禁輸
きんもつ	禁物
きんむさき	勤務先
きんむ	勤務
きんみゃく	金脈
きんみつ	緊密
ぎんみ	吟味
ぎんまく	銀幕
きんぼし	金星
きんぼう	近傍
きんぺん	近辺
きんべん	勤勉
きんぶん	均分
きんぴん	金品
ぎんばん	銀盤
ぎんぱつ	銀髪
きんぱつ	金髪
ぎんぱく	銀箔
きんぱく	金箔
きんぱく	緊迫
きんねん	近年
きんにくつう	筋肉痛
きんにく	筋肉
きんとう	均等
きんてい	謹呈
きんてい	欽定
きんちょう	金打
きんちょう	緊張
きんちょ	近著
きんちゃく	近着
きんちさん	禁治産
きんだん	禁断
きんだい	近代
きんたい	勤怠
きんそくれい	禁足令
きんぞく	金属
きんぞく	勤続
きんそく	禁足
きんせんか	金盞花
きんぜん	欣然
きんせん	金銭
きんせつ	近接
ぎんせい	銀製
きんせい	金星
きんせい	近世
きんせい	謹製
きんせい	禁制
きんせい	均整
きんしん	近親
きんしん	謹慎
きんじょうとうち	金城湯池
ぎんじょう	吟醸
ぎんしょう	銀賞
ぎんしょう	吟唱
きんしょう	金賞
きんしょう	僅少
きんじょ	近所
きんしゅく	緊縮
きんしゅ	金種
きんしゅ	禁酒
きんじとう	金字塔
きんじつ	近日
きんしつ	均質
きんじち	近似値
きんじ	近似
きんじ	禁じ
きんし	近視
きんし	禁止
ぎんざん	銀山
きんさく	金策
きんさく	近作
きんざい	近在
ぎんざ	銀座
きんさ	僅差
ぎんこんしき	銀婚式
きんこんしき	金婚式
きんこつ	筋骨
ぎんこう	銀行
きんこう	金鉱
きんこう	金工
きんこう	近郊
きんこう	均衡
きんこ	金庫
きんこ	禁固
きんげん	謹厳
きんけん	金権
きんけん	金券
きんけん	近県
きんけい	近景
きんけい	謹啓
きんく	禁句
きんぎん	金銀
きんきん	近々
きんきょり	近距離
きんきょう	近況
きんぎょ	金魚
きんきゅう	緊急
きんき	欣喜
きんがん	近眼
きんかん	金冠
きんかん	近刊
きんがく	金額
きんかい	金塊
きんかい	近海
ぎんが	銀河
ぎんか	銀貨
きんが	謹賀
きんか	金貨
きんか	近火
きんえん	禁煙
ぎんえい	吟詠
きんえい	近影
きんいん	近因
ぎんいろ	銀色
きんいろ	金色
きんいつ	均一
ぎん	銀
ぎん	吟
きん	金
きん	菌
きん	禁
きわめて	極めて
きわめつく	窮め尽く
きわめつき	極めつき
きわめ	極め
きわめ	究め
きわみ	極み
きわま	極ま
きわま	窮ま
きわだ	際だ
ぎわく	疑惑
きわ	際
ぎろん	議論
きろく	記録
きろ	帰路
きろ	岐路
きれめ	切れ目
きれま	切れ間
きれはし	切れ端
きれつ	亀裂
きれつ	き裂
きれこ	切れ込
きれぎれ	切れ切れ
ぎれい	儀礼
きれい	綺麗
きれい	奇麗
きりん	麒麟
きりわけ	切り分け
きりょく	気力
ぎりょう	議了
ぎりょう	技倆
ぎりょう	技量
きりょう	器量
きりゅう	気流
きりもり	切盛り
きりまわ	切り回
きりふだ	切札
きりひら	切り開
きりはり	切り貼り
きりはな	切り離
きりはな	切り放
きりぬき	切抜き
きりぬ	切り抜
きりぬ	切りぬ
きりとり	切取り
きりとり	切り取り
きりと	切り取
きりつめ	切り詰め
きりつ	起立
きりつ	規律
きりたんぽ	切りたんぽ
きりだ	切り出
きりた	切り立
きりすて	切捨て
きりすて	切り捨て
きりさめ	霧雨
きりさげ	切下げ
きりさげ	切り下げ
きりこ	切り込
きりくち	切口
きりくず	切り崩
きりきず	切傷
きりきざ	切り刻
きりかわ	切り替わ
きりかぶ	切株
きりかえ	切替え
きりかえ	切替
きりかえ	切り替え
きりおと	切り落と
きりあげ	切上げ
きりあげ	切り上げ
ぎり	切り
ぎり	義理
きり	霧
きり	切り
きり	桐
きらめ	煌
きらめ	燐
きらく	気楽
きらい	嫌い
きらい	帰来
きら	切ら
きら	嫌
きよわ	気弱
ぎょろう	漁撈
きょれい	虚礼
ぎょるい	魚類
ぎょりん	魚鱗
きょりゅう	居留
きょり	距離
きょり	巨利
きよらか	清らか
ぎょらい	魚雷
きょらい	去来
きょよう	許容
ぎょめい	御名
きよめ	清め
きょむ	虚無
ぎょみん	漁民
きょほう	虚報
きょほう	巨峰
ぎょぶつ	御物
ぎょふ	漁夫
きょふ	巨富
きょひ	拒否
きょひ	巨費
きょねん	去年
きょにんか	許認可
ぎょにく	魚肉
きょどう	挙動
きょとう	挙党
きょとう	巨頭
きょてん	拠点
きょっけい	極刑
きょっかい	曲解
きょだつ	虚脱
きょだく	許諾
きょたく	居宅
きょだい	巨大
ぎょそん	漁村
きょぞう	虚像
きょぞう	巨象
ぎょせん	漁船
きょぜつ	拒絶
きょせい	虚勢
きょせい	巨星
きょせい	去勢
きょすう	虚数
きょしんたんかい	虚心坦懐
きょじん	巨人
きょしん	虚心
きょしょくしょう	拒食症
きょしょく	虚飾
ぎょじょう	漁場
ぎょしょう	漁礁
きょしょう	裾礁
きょしょう	巨匠
きょしょ	居所
きょしゅつ	醵出
きょしゅつ	拠出
きょじゅう	居住
きょしゅう	去就
きょしゅ	挙手
きょじゃく	虚弱
きょしてき	巨視的
きょじつ	虚実
きょしつ	居室
きょしき	挙式
ぎょじ	御璽
きょし	挙止
きょこん	許婚
きょこん	虚根
ぎょこう	漁港
きょごう	倨傲
きょこう	虚構
きょこう	挙行
きょげん	虚言
ぎょぐん	魚群
きょくろん	極論
きょくりょく	極力
きょくりつ	曲率
きょくもく	曲目
きょくめん	曲面
きょくめん	局面
きょくぶ	局部
きょくばん	局番
きょくない	局内
きょくどめ	局留め
きょくどめ	局留
きょくとう	極東
きょくど	極度
きょくてん	極点
きょくちょう	曲調
きょくちょう	局長
きょくち	極致
きょくち	極地
きょくち	局地
きょくたん	極端
きょくだい	極大
きょくせん	曲線
きょくせつ	曲折
ぎょくせきこんこう	玉石混淆
きょくせい	極性
きょくしょかい	局所解
きょくしょう	極少
きょくしょう	極小
きょくしょ	局所
ぎょくさい	玉砕
きょくざい	局在
ぎょくざ	玉座
きょくげん	極限
きょくげん	極言
きょくげん	局限
きょくげい	曲芸
きょくぎ	曲技
きょくいん	局員
ぎょぐ	漁具
ぎょく	玉
きょく	極
きょく	曲
きょく	局
きょきょじつじつ	虚々実々
ぎょぎょう	漁業
ぎょきょう	漁協
きょぎょう	虚業
きょぎ	虚偽
ぎょがん	魚眼
きょがく	巨額
ぎょかい	魚介
きょか	許可
ぎょえい	魚影
きょえい	虚栄
きょうわせい	共和制
きょうわこく	共和国
きょうわ	協和
きょうわ	共和
きょうれん	教練
ぎょうれつ	行列
きょうれつ	強烈
きょうれい	強冷
きょうりょく	強力
きょうりょく	協力
きょうりょう	狭量
きょうりょう	橋梁
きょうりゅう	恐竜
きょうりつ	共立
きょうり	郷里
きょうらん	狂乱
きょうらん	供覧
きょうらく	享楽
きょうよう	教養
きょうよう	強要
きょうよう	共用
きょうよ	供与
きょうゆう	梟雄
きょうゆう	共有
きょうゆう	享有
きょうゆ	教諭
きょうやく	協約
きょうめん	鏡面
きょうめい	響鳴
きょうめい	共鳴
ぎょうむ	業務
きょうむ	教務
きょうみ	興味
ぎょうまつ	行末
きょうま	京間
きょうほん	狂奔
きょうぼく	喬木
きょうぼう	狂暴
きょうぼう	凶暴
きょうぼう	共謀
きょうほ	競歩
きょうべん	教鞭
きょうべん	強弁
きょうぶんさん	共分散
きょうふう	強風
きょうぶ	胸部
きょうふ	恐怖
きょうび	今日日
きょうはん	共犯
きょうはく	脅迫
きょうはく	強迫
きょうばい	競売
きょうねん	享年
きょうとうほ	橋頭堡
きょうどうたい	共同体
ぎょうとう	行頭
きょうどう	経堂
きょうどう	協同
きょうどう	共同
きょうとう	驚倒
きょうとう	教頭
きょうとう	共闘
きょうど	郷土
きょうど	強度
きょうと	教徒
きょうてんどうち	驚天動地
ぎょうてん	仰天
きょうてん	経典
きょうてき	強敵
きょうてい	教程
きょうてい	協定
きょうてい	競艇
きょうつう	共通
きょうちょう	強調
きょうちょう	協調
きょうちょう	凶兆
きょうちょ	共著
きょうちゅう	胸中
きょうち	境地
きょうだん	教壇
きょうだん	教団
きょうだん	凶弾
きょうたん	驚嘆
きょうたく	供託
ぎょうたい	業態
きょうだい	兄弟
きょうだい	鏡台
きょうだい	橋台
きょうだい	強大
きょうたい	狂態
きょうだ	怯懦
きょうだ	強打
きょうぞん	共存
きょうそん	共存
きょうぞめ	京染
きょうそく	教則
きょうそうきょく	協奏曲
ぎょうそう	形相
きょうぞう	鏡像
きょうぞう	胸像
きょうそう	強壮
きょうそう	競走
きょうそう	競争
きょうそ	教祖
ぎょうせき	業績
ぎょうせい	行政
きょうせい	矯正
きょうせい	教生
きょうせい	強請
きょうせい	強制
きょうせい	共生
きょうせい	共棲
ぎょうずい	行水
きょうしんしょう	狭心症
きょうじん	狂人
きょうじん	強靭
きょうしん	強震
きょうしん	強心
きょうしん	共振
きょうしょく	教職
ぎょうしょう	行商
きょうじょう	教条
きょうじょう	教場
きょうしょう	狭小
ぎょうしょ	行書
きょうしょ	教書
きょうじゅん	恭順
きょうじゅつ	供述
きょうしゅつ	供出
ぎょうしゅく	凝縮
きょうしゅく	恐縮
きょうしゅうじょ	教習所
ぎょうしゅう	凝集
きょうしゅう	郷愁
きょうしゅう	強襲
ぎょうしゅ	業種
きょうじゅ	教授
きょうじゅ	享受
きょうじゃく	強弱
ぎょうしゃ	業者
きょうしゃ	強者
きょうしつ	教室
きょうしき	胸式
ぎょうじ	行事
ぎょうじ	行司
ぎょうし	凝視
きょうじ	矜持
きょうじ	教示
きょうじ	凶事
きょうじ	共時
きょうし	教師
きょうさん	協賛
きょうさん	共産
きょうざめ	興ざめ
きょうざつ	夾雑
きょうさく	凶作
きょうさく	競作
きょうざい	教材
きょうさい	恐妻
きょうさい	共済
きょうさい	共催
ぎょうざ	餃子
きょうさ	教唆
きょうこつ	胸骨
きょうこく	強国
きょうこく	峡谷
きょうこうぐん	強行軍
きょうごう	強豪
きょうごう	競合
きょうこう	恐慌
きょうこう	強行
きょうこう	強硬
きょうこう	凶行
ぎょうこ	凝固
きょうご	教護
きょうこ	強固
きょうけんびょう	狂犬病
きょうげん	狂言
きょうけん	強権
きょうけん	強健
ぎょうけつ	凝血
ぎょうけつ	凝結
きょうけつ	供血
きょうげき	挟撃
きょうげき	京劇
きょうくん	教訓
きょうぐう	境遇
きょうきん	胸襟
ぎょうぎょうし	仰々し
きょうぎょう	協業
きょうきゅう	供給
きょうきゃく	橋脚
ぎょうぎ	行儀
きょうぎ	経木
きょうぎ	狭義
きょうぎ	教義
きょうぎ	協議
きょうぎ	競技
きょうき	驚喜
きょうき	狂気
きょうき	狂喜
きょうき	凶器
きょうき	侠気
ぎょうかん	行間
きょうかん	教官
きょうかん	共感
きょうかつ	恐喝
きょうかしょ	教科書
ぎょうかく	行革
ぎょうかく	仰角
きょうがく	驚愕
きょうがく	共学
きょうかく	胸郭
きょうかく	侠客
ぎょうかい	業界
きょうがい	境涯
きょうかい	教誨
きょうかい	教会
きょうかい	境界
きょうかい	協会
きょうが	恭賀
きょうか	教科
きょうか	教化
きょうか	強化
きょうおう	供応
きょうえん	饗宴
きょうえん	共演
きょうえん	競演
きょうえつ	恐悦
きょうえき	共益
きょうえい	共栄
きょうえい	競泳
きょういん	教員
きょういく	教育
きょうい	驚異
きょうい	脅威
きょうい	胸囲
きょうい	強意
きょうあい	狭隘
ぎょう	行
きよう	起用
きよう	器用
きょう	今日
きょう	経
きょう	饗
きょう	興
きょう	狂
きょう	強
きょう	境
きょう	卿
きょう	凶
きょう	供
きょう	京
ぎょい	御意
ぎょ	御
きよ	清
きよ	寄与
きょ	虚
きょ	挙
きょ	居
きゅうれき	旧暦
きゅうれい	急冷
きゅうりょうび	給料日
きゅうりょう	給料
きゅうりょう	丘陵
きゅうりゅう	急流
きゅうり	胡瓜
きゅうらく	急落
きゅうらい	旧来
きゅうよう	急用
きゅうよう	休養
きゅうよ	給与
きゅうゆう	旧友
きゅうゆう	級友
きゅうゆ	給油
きゅうめん	球面
きゅうめい	糾明
きゅうめい	究明
きゅうめい	救命
きゅうむ	急務
きゅうみん	休眠
きゅうぼう	窮乏
きゅうほう	急報
ぎゅうほ	牛歩
きゅうぼ	急募
きゅうへん	急変
きゅうふきん	給付金
きゅうふ	給付
きゅうびょう	急病
きゅうばん	吸盤
きゅうはん	旧版
きゅうはく	窮迫
きゅうはく	急迫
ぎゅうば	牛馬
きゅうば	急場
きゅうは	急派
きゅうねん	旧年
きゅうねつ	急熱
ぎゅうにゅう	牛乳
きゅうにゅう	吸入
ぎゅうにく	牛肉
きゅうどう	旧道
きゅうどう	弓道
きゅうとう	給湯
きゅうとう	急騰
きゅうでん	給電
きゅうでん	宮殿
きゅうてん	急転
きゅうていしゃ	急停車
きゅうてい	宮廷
きゅうちょう	級長
きゅうちゅう	宮中
きゅうちゃく	吸着
きゅうち	旧知
きゅうち	窮地
きゅうだん	給弾
きゅうだん	糾弾
きゅうだん	球団
きゅうだい	及第
きゅうたい	旧態
きゅうたい	球体
きゅうそく	急速
きゅうそく	休息
きゅうぞう	急増
きゅうそう	急送
きゅうせんぽう	急先鋒
きゅうせん	休戦
きゅうせき	旧跡
きゅうせき	求積
きゅうせいちょう	急成長
きゅうせいしゅ	救世主
きゅうせい	旧姓
きゅうせい	旧制
きゅうせい	急逝
きゅうせい	急性
きゅうすう	級数
きゅうすい	給水
きゅうすい	吸水
きゅうす	急須
きゅうじん	求人
きゅうしん	急進
きゅうしん	休診
きゅうじょたい	救助隊
きゅうしょく	給食
きゅうしょく	求職
きゅうしょく	休職
きゅうじょうしょう	急上昇
きゅうじょう	窮状
きゅうじょう	球状
きゅうじょう	球場
きゅうじょう	宮城
きゅうじょう	休場
きゅうじょ	救助
きゅうしょ	急所
きゅうしゅん	急峻
きゅうしゅつ	救出
きゅうしゅう	吸収
きゅうしゃ	厩舎
きゅうしふ	休止符
きゅうじつ	休日
きゅうしき	旧式
きゅうじ	給仕
きゅうし	急死
きゅうし	休止
きゅうし	臼歯
きゅうさい	救済
きゅうさい	休載
きゅうこん	球根
きゅうこん	求婚
きゅうこく	急告
きゅうこうか	急降下
きゅうごう	鳩合
きゅうごう	糾合
きゅうこう	急行
きゅうこう	休講
きゅうこう	休耕
きゅうこう	休校
ぎゅうご	牛後
きゅうご	救護
きゅうげん	急減
きゅうけつき	吸血鬼
きゅうけつ	吸血
きゅうげき	急激
きゅうけい	球形
きゅうけい	求刑
きゅうけい	急啓
きゅうけい	休憩
きゅうくつ	窮屈
きゅうきん	給金
きゅうきょく	究極
きゅうぎょう	休業
きゅうきょ	急遽
きゅうきょ	急きょ
きゅうきゅうしゃ	救急車
きゅうきゅう	汲々
きゅうきゅう	救急
きゅうぎ	球技
きゅうき	吸気
きゅうかんちょう	九官鳥
きゅうかん	旧館
きゅうかん	急患
きゅうかん	休館
きゅうかん	休閑
きゅうかん	休刊
きゅうかな	旧仮名
きゅうかな	旧カナ
きゅうがく	休学
きゅうかく	球殻
きゅうかい	休会
きゅうか	旧家
きゅうか	休暇
きゅうえん	救援
きゅうえん	休演
きゅういん	吸引
きゅうあい	求愛
ぎゅう	牛
きゆう	杞憂
きゅう	九
きゅう	旧
きゅう	給
きゅう	級
きゅう	窮
きゅう	球
きゅう	灸
きゅう	急
きゅう	休
きゅう	仇
ぎゃっこう	逆行
きゃっこう	脚光
ぎゃっきょう	逆境
きゃっかん	客観
きゃっか	却下
きゃたつ	脚立
きやせ	着痩せ
きやすめ	気休め
きやす	気安
きゃしゃ	華奢
ぎゃくりゅう	逆流
ぎゃくり	逆理
ぎゃくよう	逆用
ぎゃくもどり	逆戻り
きゃくま	客間
きゃくほん	脚本
ぎゃくふう	逆風
きゃくど	客土
ぎゃくてん	逆転
きゃくちゅう	脚注
ぎゃくたい	虐待
きゃくせん	脚線
きゃくせん	客船
ぎゃくせつ	逆説
ぎゃくせつ	逆接
きゃくせき	客席
ぎゃくすう	逆数
きゃくじん	客人
きゃくしょく	脚色
ぎゃくじょう	逆上
ぎゃくじゅん	逆順
ぎゃくしゅう	逆襲
きゃくしゃ	客車
きゃくしつ	客室
きゃくし	客死
ぎゃくさん	逆算
ぎゃくさつ	虐殺
きゃくえん	客演
きゃくいん	脚韻
きゃくいん	客員
きゃくあし	客足
ぎゃく	逆
きやく	規約
きゃく	客
ぎもんし	疑問視
ぎもん	疑問
きもん	鬼門
きもの	着物
きもったま	肝っ玉
きもち	気持ち
きもち	気持
きも	肝
きめて	決め手
きめつけ	決めつけ
きめこまか	きめ細か
きめこ	決め込
ぎめい	偽名
きめい	記名
きめ	木目
きめ	肌理
きめ	決め
ぎむづけ	義務づけ
きむづかし	気難し
きむずかし	気難し
ぎむ	義務
きみょう	奇妙
きみどり	黄緑
きみつ	機密
きみたち	君達
きみじか	気短
きみがわる	気味が悪
ぎみ	気味
きみ	君
きみ	気味
きみ	黄身
ぎまん	欺瞞
きまま	気まま
きまって	決って
きまつ	期末
きまず	気まず
きまぐれ	気まぐれ
きまえ	気前
きま	決ま
きま	決
きま	極
きほん	基本
きぼり	木彫り
きぼね	気骨
ぎほう	技法
きぼう	希望
きほう	貴方
きほう	記法
ぎぼ	義母
きぼ	規模
ぎへんすう	疑変数
きべん	詭弁
きへい	騎兵
ぎふん	義憤
きぶん	気分
きぶとり	着太り
きぶっせい	気ぶっせい
きぶくれ	着膨れ
きふく	起伏
きふう	気風
ぎふ	義父
きふ	寄付
きびん	機敏
きひん	貴賓
きひん	気品
きびょう	奇病
きひょう	起票
きひつ	起筆
きびたき	黄鶲
きびす	踵
きびし	厳し
きびき	忌引
きび	黍
きび	機微
きひ	忌避
きばん	基盤
きはん	規範
きばらし	気晴らし
きはつゆ	揮発油
きばつ	奇抜
きはつ	揮発
きばたらき	気ばたらき
きはだ	木肌
きはずかし	気恥ずかし
きはじめ	来始め
きはじめ	来はじめ
きばく	起爆
きはく	気迫
きはく	希薄
きば	木場
きば	騎馬
きば	気張
きば	牙
きば	黄ば
きのり	気乗り
きのどく	気の毒
きのと	乙
きのこ	茸
きのえ	甲
ぎのう	技能
きのう	昨日
きのう	帰納
きのう	機能
きねんひん	記念品
きねんび	記念日
きねんひ	記念碑
ぎねん	疑念
きねん	記念
きねん	祈念
きね	杵
きぬた	砧
きぬがさ	衣笠
きぬいと	絹糸
きぬ	絹
きぬ	衣
きにん	帰任
きにゅう	記入
きにち	忌日
きにい	気に入
きなさ	来なさ
きなが	気長
きない	機内
きどるい	希土類
きとく	既得
きとく	奇特
きとく	危篤
きどうたい	機動隊
きどう	軌道
きどう	起動
きどう	機動
きとう	祈祷
きとう	帰投
きど	木戸
きど	輝度
きど	気取
きど	気ど
きと	帰途
きと	企図
きでん	貴殿
きてん	起点
きてん	貴店
きてん	機転
きてん	基点
きてき	汽笛
きていち	既定値
ぎてい	議定
きてい	規程
きてい	規定
きてい	既定
きてい	基底
きつもん	詰問
きっぽう	吉報
きっぷ	切符
きっぷ	気っ風
きつね	狐
きって	切手
きつつき	啄木鳥
きっちょう	吉兆
きづち	木槌
きっせき	詰責
きっすい	生粋
きっすい	喫水
ぎっしゃ	牛車
きっさてん	喫茶店
きっさき	切先
きっさ	喫茶
きっこう	亀甲
きづけ	気付
きつけ	着付け
きっく	キック
きっきょう	吉凶
きづかれ	気疲れ
きっかけ	切っ掛け
きづか	気遣
きつえん	喫煙
きづ	気付
きづ	気づ
きっ	喫
きちょうめん	几帳面
ぎちょう	議長
きちょう	貴重
きちょう	記帳
きちょう	機長
きちょう	基調
きちゅう	忌中
きちゃく	帰着
きちじつ	吉日
きちじ	吉事
きちがい	気違い
きち	吉
きち	貴地
きち	機知
きち	既知
きち	基地
きだん	気団
きたん	忌憚
きたる	来る
きたまわり	北回り
きたはんきゅう	北半球
きたならし	汚らし
きたな	汚
きだて	気だて
きたけ	着丈
きたぐち	北口
きたく	帰宅
きたく	寄託
きたがわ	北側
きたかぜ	北風
きたえあげ	鍛え上げ
きたえ	鍛え
きたいち	期待値
ぎだい	議題
きだい	貴台
きたい	稀代
きたい	気体
きたい	機体
きたい	期待
きたい	奇態
きたい	奇体
きたい	危殆
きた	来た
きた	来
きた	北
きぞん	既存
きそん	毀損
きそん	既存
ぎぞく	義賊
ぎそく	義足
きぞく	貴族
きぞく	帰属
きそく	規則
きそく	気息
きそうてんがい	奇想天外
ぎぞう	偽造
ぎそう	艤装
ぎそう	擬装
ぎそう	偽装
きぞう	寄贈
きそう	起草
きそう	寄贈
きそ	競
きそ	起訴
きそ	基礎
ぎぜん	偽善
きぜん	毅然
きせん	汽船
きせん	基線
きぜつ	気絶
きせつ	季節
きせつ	既設
ぎせき	議席
きせき	軌跡
きせき	奇跡
ぎせい	犠牲
きせい	規正
きせい	規制
きせい	気勢
きせい	帰省
きせい	既製
きせい	既成
きせい	寄生
きせい	奇声
きせ	着せ
きずな	絆
きずつけ	傷つけ
きずつ	傷つ
きずぐち	傷口
きずきあげ	築き上げ
きすう	帰趨
きすう	奇数
きすい	既遂
きずあと	傷跡
きず	瑕
きず	築
きず	傷
きす	鱚
ぎしんあんき	疑心暗鬼
ぎじん	擬人
ぎしん	疑心
きじん	奇人
きしん	貴信
きしん	寄進
ぎじろく	議事録
きしょく	気色
きしょうてんけつ	起承転結
きしょうだい	気象台
ぎじょう	議場
ぎしょう	偽証
ぎしょう	偽称
きじょう	騎乗
きじょう	軌条
きじょう	気丈
きじょう	機上
きじょう	机上
きしょう	起床
きしょう	記章
きしょう	稀少
きしょう	気性
きしょう	気象
きしょう	希少
ぎしょ	偽書
きじょ	貴女
きしょ	貴書
きしょ	期初
きじゅん	規準
きじゅん	基準
ぎじゅつ	技術
きじゅつ	記述
きじゅつ	奇術
きしゅつ	既出
きしゅく	寄宿
きじゅうき	起重機
きじゅう	機銃
きしゅう	奇襲
ぎしゅ	義手
きじゅ	喜寿
きしゅ	騎手
きしゅ	機首
きしゅ	機種
きしゅ	期首
きしゅ	旗手
きしゅ	奇手
きしゃく	希釈
きしゃ	貴社
きしゃ	記者
きしゃ	汽車
きしゃ	帰社
きしべ	岸辺
きじばと	雉鳩
ぎじどう	議事堂
きじつ	期日
きしつ	気質
きじく	機軸
きじく	基軸
ぎしき	儀式
きしかいせい	起死回生
ぎじ	議事
ぎじ	疑似
ぎし	義肢
ぎし	技師
ぎし	技士
きじ	雉
きじ	木地
きじ	生地
きじ	記事
きし	軋
きし	騎士
きし	貴誌
きし	棋士
きし	岸
きさん	起算
きさん	帰参
きさらぎ	如月
きざみつけ	刻みつけ
きざみこ	刻み込
きざみ	刻
きさま	貴様
ぎさく	偽作
きさく	気さく
きさき	妃
きさき	后
きざい	機材
きさい	鬼才
きさい	起債
きさい	記載
きさい	既済
きさい	奇才
きざ	萌
きざ	兆
きざ	刻
きざ	気障
きこん	既婚
きこな	着こな
きこつ	気骨
きこしめ	聞こし召
きごころ	気心
ぎごく	疑獄
きこく	貴国
きこく	帰国
きこえよがし	聞こえよがし
きこえ	聞こえ
きこうぼん	稀覯本
きこうし	貴公子
ぎこう	技巧
きごう	記号
きごう	揮毫
きこう	起工
きこう	貴校
きこう	紀行
きこう	稀覯
きこう	気孔
きこう	気功
きこう	気候
きこう	帰港
きこう	機構
きこう	寄稿
きこう	寄港
きこう	奇行
きご	季語
きこ	着込
きげんぜん	紀元前
きげん	起源
きげん	紀元
きげん	機嫌
きげん	期限
きけん	気圏
きけん	棄権
きけん	危険
ぎけつ	議決
きけつ	帰結
きけつ	既決
きげき	喜劇
きけい	貴兄
きけい	奇形
きくん	貴君
きぐろう	気苦労
きぐらい	気位
きくみ	菊見
きくばり	気配り
きくばり	気くばり
きぐう	奇遇
きぐ	機具
きぐ	器具
きぐ	危惧
きく	鞠
きく	菊
きく	掬
きく	規矩
ききんぞく	貴金属
ききん	寄金
ききん	基金
ききわけ	聞き分け
ぎきょく	戯曲
きぎょうたい	企業体
ぎきょうしん	義侠心
きぎょうか	起業家
きぎょう	起業
きぎょう	企業
ききょう	桔梗
ききょう	帰郷
ききょう	帰京
ききょう	奇矯
ききょ	起居
ききゅう	気球
ききゅう	希求
ききゃく	棄却
ききめ	効き目
ききなが	聞き流
ききと	聞き取
ききて	聞き手
ききだ	聞き出
ききこ	聞き込
ききこ	聴き込
ききぐるし	聞き苦し
ききかえ	聞き返
ききいれ	聞き入れ
ききいっぱつ	危機一髪
ききい	聞き入
ききい	聴き入
ぎぎ	疑義
きき	効き
きき	機器
きき	危機
きかんしゃ	機関車
きかんしえん	気管支炎
きかんし	気管支
ぎかん	技官
きがん	祈願
きかん	貴簡
きかん	季刊
きかん	気管
きかん	帰還
きかん	機関
きかん	期間
きかん	既刊
きかん	基幹
きかん	器官
きがる	気軽
きがまえ	気構え
きがね	気兼ね
きかざ	着飾
きがく	器楽
きかく	規格
きかく	企画
きがかり	気がかり
きかがく	幾何学
きがえ	着替え
きかいか	機械化
ぎかい	議会
きがい	気概
きがい	危害
きかい	機械
きかい	機会
きかい	奇怪
きかい	器械
きが	飢餓
きか	貴下
きか	気化
きか	帰化
きか	幾何
ぎおん	擬音
きおん	気温
きおち	気落ち
きおくれ	気遅れ
きおく	記憶
きおうしょう	既往症
きおう	既往
きおいた	気負い立
きお	気負
ぎえんきん	義援金
きえん	気炎
きえさ	消え去
きえい	消え入
きえい	気鋭
きえい	機影
きえ	消え
きえ	帰依
きうん	気運
きうん	機運
きう	気宇
ぎいん	議院
ぎいん	議員
きいん	起因
きいろ	黄色
きいと	生糸
きい	貴意
きい	奇異
ぎあん	議案
きあん	起案
きあつ	気圧
ぎあく	偽悪
きあい	気合い
ぎ	切
ぎ	議
ぎ	義
ぎ	擬
ぎ	儀
き	利
き	木
き	聞
き	伐
き	聴
き	着
き	切
き	訊
き	樹
き	斬
き	効
き	記
き	季
き	気
き	帰
き	機
き	期
き	忌
き	奇
き	基
き	器
き	黄
かんわきゅうだい	閑話休題
かんわ	緩和
かんわ	漢和
かんろに	甘露煮
かんろく	貫禄
がんろう	玩弄
かんろ	甘露
かんろ	寒露
かんれん	関連
かんれき	還暦
かんれい	慣例
かんれい	寒冷
かんるい	感涙
がんりょう	顔料
かんりょう	官僚
かんりょう	完了
かんりゅう	寒流
かんりゃくか	簡略化
かんりゃく	簡略
かんりにん	管理人
かんりしょく	管理職
かんりしゃ	管理者
がんりき	眼力
がんり	元利
かんり	管理
かんり	官吏
かんらん	観覧
かんらく	陥落
かんらく	歓楽
がんらい	元来
かんようしょくぶつ	観葉植物
かんよう	肝要
かんよう	慣用
かんよう	寛容
かんよ	関与
がんゆう	含有
かんゆう	勧誘
かんゆ	換喩
がんやく	丸薬
かんやく	簡約
かんやく	監訳
かんやく	完訳
かんもん	関門
かんもん	喚問
がんもく	眼目
がんめん	顔面
がんめいころう	頑迷固陋
がんめい	頑迷
かんめい	簡明
かんめい	感銘
かんむりょう	感無量
かんむり	冠
かんみん	官民
かんみ	甘味
かんまん	緩慢
かんまん	干満
かんまつ	巻末
がんぽん	元本
かんぼつ	陥没
かんぼく	潅木
かんぽうやく	漢方薬
かんぽうのまじわり	管鮑の交わり
がんぼう	願望
かんぽう	漢方
かんぽう	官報
かんぼう	感冒
かんぼう	官房
かんべん	簡便
かんべん	勘弁
かんべつ	鑑別
がんぺき	岸壁
かんぺき	完璧
かんぺき	完ぺき
かんぶん	漢文
かんぶつ	乾物
かんぷく	感服
かんぷう	完封
かんぷう	寒風
かんぷ	還付
かんぷ	完膚
かんぷ	乾布
かんぶ	患部
かんぶ	幹部
かんぴょう	干瓢
かんぴょう	乾瓢
かんびょう	看病
がんぴし	雁皮紙
かんび	完備
がんばん	岩盤
かんぱん	甲板
かんぱん	乾パン
かんばん	看板
かんぱつ	煥発
かんばつ	旱魃
かんばつ	間伐
かんばつ	簡抜
かんばし	芳し
かんぱく	関白
かんぱい	完敗
かんぱい	乾杯
かんばい	完売
かんばい	寒梅
がんば	頑張
かんぱ	寒波
かんぱ	カンパ
かんば	悍馬
かんのん	観音
かんのう	感応
かんのう	官能
かんのう	完納
がんねん	元年
かんねん	観念
かんぬし	神主
かんにん	堪忍
かんにゅう	貫入
かんなづき	神無月
かんない	館内
かんない	艦内
かんない	管内
かんな	鉋
かんとく	監督
かんどうみゃく	冠動脈
かんどうし	感動詞
かんどう	感動
かんどう	勘当
かんとう	敢闘
かんとう	巻頭
かんど	感度
かんでんち	乾電池
かんでん	感電
かんてん	観点
かんてつ	貫徹
かんてい	鑑定
かんてい	艦艇
かんてい	官邸
かんづめ	缶詰
かんつう	貫通
かんづ	感付
かんづ	感づ
かんづ	勘付
かんづ	勘づ
かんちょう	浣腸
かんちょう	館長
かんちょう	間諜
かんちょう	艦長
かんちょう	管長
かんちょう	干潮
かんちょう	官庁
がんちゅう	眼中
かんちゅう	寒中
がんちく	含蓄
かんちがい	勘違い
かんち	関知
かんち	感知
がんたん	元旦
かんだん	間断
かんだん	歓談
かんだん	寒暖
かんたん	簡単
かんたん	感嘆
かんたく	干拓
かんだい	寛大
かんたい	艦隊
かんたい	歓待
かんたい	寒帯
かんそん	寒村
かんそく	観測
かんぞう	肝臓
かんそう	歓送
かんそう	感想
かんそう	完走
かんそう	乾燥
がんそ	元祖
かんそ	簡素
かんぜん	敢然
かんぜん	完全
かんせん	観戦
かんせん	艦船
かんせん	汗腺
かんせん	感染
かんせん	幹線
かんせつ	関節
かんせつ	間接
がんせき	岩石
かんぜい	関税
かんせい	閑静
かんせい	管制
かんせい	歓声
かんせい	慣性
かんせい	感性
かんせい	官製
かんせい	完成
かんせい	喚声
かんせい	乾性
かんすう	関数
かんすい	灌水
かんすい	潅水
かんすい	完遂
かんすい	冠水
かんしんじ	関心事
かんじん	肝腎
かんじん	肝心
かんしん	関心
かんしん	歓心
かんしん	感心
がんしょく	顔色
かんしょく	閑職
かんしょく	間食
かんしょく	感触
かんしょうてき	感傷的
がんじょう	頑丈
がんしょう	岩礁
かんじょう	環状
かんじょう	感情
かんじょう	勘定
かんしょう	鑑賞
かんしょう	観賞
かんしょう	緩衝
かんしょう	環礁
かんしょう	感傷
かんしょう	干渉
がんしょ	願書
かんじょ	寛恕
かんじょ	官女
かんしょ	甘薯
かんじゅせい	感受性
かんじゅく	完熟
がんしゅう	含羞
かんしゅう	観衆
かんしゅう	監修
かんしゅう	慣習
かんじゅ	甘受
かんしゅ	看守
かんしゅ	看取
かんしゃくだま	癇癪玉
かんしゃくだま	かんしゃく玉
かんじゃく	閑寂
かんしゃく	癇癪
かんじゃ	患者
かんしゃ	感謝
かんしゃ	官舎
かんじと	感じと
かんして	関して
がんじつ	元日
かんしつ	乾湿
かんしき	鑑識
かんしき	乾式
かんじ	監事
かんじ	漢字
かんじ	換字
かんじ	感じ
かんじ	幹事
かんし	監視
かんざん	換算
かんさん	閑散
かんさん	換算
かんさつ	鑑札
かんさつ	観察
かんさつ	監察
がんさく	贋作
かんざい	管財
かんさい	簡裁
かんさい	完済
かんさ	鑑査
かんさ	監査
かんこんそうさい	冠婚葬祭
かんごふ	看護婦
かんこどり	閑古鳥
かんこつだったい	換骨奪胎
かんごく	監獄
かんこく	勧告
かんこうれい	箝口令
かんこうへん	肝硬変
かんこうちょう	官公庁
がんこうしゅてい	眼高手低
かんこうきゃく	観光客
がんこう	眼光
かんこう	観光
かんこう	緩行
かんこう	敢行
かんこう	慣行
かんこう	感光
かんこう	完工
かんこう	刊行
がんこ	頑固
かんご	看護
かんこ	歓呼
かんげんがく	管弦楽
がんけん	頑健
かんげん	還元
かんげん	諌言
かんげん	甘言
かんげん	換言
かんけつ	間欠
かんけつ	簡潔
かんけつ	完結
かんげき	間隙
かんげき	観劇
かんげき	感激
かんけいな	関係な
かんげい	歓迎
かんけい	関係
かんぐん	官軍
がんぐ	玩具
かんぐ	勘繰
かんぐ	勘ぐ
かんく	管区
がんきん	元金
かんきん	監禁
かんきん	換金
がんきょう	頑強
がんきょう	眼鏡
かんぎょう	官業
かんぎょう	勧業
かんきょう	環境
かんきょう	感興
かんきょ	閑居
かんきょ	官許
かんぎゅうじゅうとう	汗牛充棟
がんきゅう	眼球
かんきゅう	緩急
かんきゃく	観客
かんきつ	柑橘
かんきせん	換気扇
かんき	歓喜
かんき	換気
かんき	喚起
かんき	寒気
かんき	乾期
かんがみ	鑑み
かんかつ	管轄
かんがく	官学
かんかく	間隔
かんかく	感覚
かんがえぬ	考え抜
かんがえなお	考え直
かんがえつめ	考え詰め
かんがえつ	考え付
かんがえだ	考え出
かんがえこ	考え込
かんがえかた	考え方
かんがえ	考え
がんかい	眼科医
かんがい	感慨
かんがい	干害
かんがい	寒害
かんかい	寛解
かんかい	官界
がんか	眼科
がんか	眼下
かんか	看過
かんか	感化
かんおけ	棺桶
がんえん	岩塩
かんえん	肝炎
かんいん	館員
かんいん	姦淫
かんいっぱつ	間一髪
がんい	含意
かんい	簡易
かんあん	勘案
がん	願
がん	雁
がん	癌
かん	癇
かん	甲
かん	館
かん	関
かん	間
かん	観
かん	艦
かん	缶
かん	管
かん	棺
かん	感
かん	完
かん	姦
かん	勘
かん	寒
かん	冠
かわり	変わり
かわら	川原
かわら	瓦
かわら	河原
かわや	厠
かわばた	川端
かわぞこ	川底
かわせ	為替
かわず	蛙
かわしも	川下
かわざんよう	皮算用
かわぐつ	革靴
かわぐち	川口
かわぐち	河口
かわかみ	川上
かわか	乾か
かわいそう	可哀相
かわいそう	可哀想
かわい	可愛
がわ	側
かわ	変わ
かわ	変
かわ	皮
かわ	代わ
かわ	代
かわ	替わ
かわ	替
かわ	側
かわ	川
かわ	交わ
かわ	換わ
かわ	乾
かわ	渇
かわ	革
かわ	河
かろやか	軽やか
がろう	画廊
かれん	可憐
かれら	彼等
かれら	彼ら
かれは	枯葉
かれは	枯れ葉
かれつ	苛烈
かれし	彼氏
がれき	瓦礫
かれき	枯木
かれい	鰈
かれい	鰔
かれい	華麗
かれ	涸れ
かれ	彼
かれ	枯れ
かるわざ	軽業
かるはずみ	軽はずみ
かるがるし	軽々し
かるがる	軽々
かる	軽
かりょく	火力
がりょうてんせい	画龍点睛
がりょうてんせい	画竜点睛
かりょう	科料
かりょう	加療
がりゅう	我流
かりゅう	下流
かりめんきょ	仮免許
かりばらいきん	仮払金
かりばらい	仮払い
かりばらい	仮払
かりぬい	仮縫い
かりと	刈り取
かりて	借り手
かりちょういん	仮調印
かりたて	駆り立て
かりだ	駆り出
かりずまい	仮住い
かりしょぶん	仮処分
かりしゃくほう	仮釈放
かりこ	借り越
かりこ	刈り込
かりき	借り切
かりかた	借方
かりうけ	借り受け
かりいれきん	借入金
かりいれ	借入れ
かりいれ	借り入れ
かりいれ	刈り入れ
かりあつめ	かり集め
かりあげ	借り上げ
かりあげ	刈り上げ
かり	猟
かり	狩り
かり	狩
かり	借り
かり	雁
かり	仮
がらんどう	伽藍堂
がらん	伽藍
からめ	絡め
からみつ	絡み付
からみあ	絡み合
からみ	空身
からまわり	空回り
からま	絡ま
からぶり	空振り
からて	空手
からっぽ	空っぽ
からっかぜ	からっ風
からたけわり	幹竹割り
からだ	体
からだ	身体
からだ	躯
がらす	硝子
からす	鴉
からす	烏
からし	芥子
からくち	辛口
からかみ	唐紙
からかさ	傘
がら	柄
から	絡
から	辛
から	枯ら
から	空
から	殻
がよく	我欲
かようび	火曜日
かようせい	可溶性
がようし	画用紙
かようきょく	歌謡曲
かよう	火曜
かよう	歌謡
かよ	通
かゆ	痒
かゆ	粥
かやく	火薬
かや	榧
かや	萱
かや	茅
かや	蚊帳
かもん	家紋
かもめ	鴎
かもつせん	貨物船
かもつ	貨物
かもしだ	醸し出
かもく	課目
かもく	科目
かもく	寡黙
かもい	鴨居
かも	醸
かも	鴨
がめん	画面
かめん	仮面
かめい	家名
かめい	加盟
かめい	仮名
かめ	瓶
かめ	亀
かみん	夏眠
かみん	仮眠
かみよ	神代
かみよ	神世
かみや	紙屋
かみはんき	上半期
かみなり	雷
かみて	上手
かみつ	過密
かみだのみ	神頼み
かみだな	神棚
かみそり	剃刀
かみしめ	噛みしめ
かみさま	神様
かみざ	上座
かみくだ	噛み砕
かみき	上期
かみがた	髪型
かみがた	上方
がみ	紙
かみ	髪
かみ	神
かみ	上
かみ	守
かみ	紙
かみ	加味
がまん	我慢
かまもと	窯元
かまめし	釜飯
かまぼこ	蒲鉾
かまち	框
かます	梭子魚
かます	梭魚
がまぐち	がま口
がまがえる	蝦蟇
かまえ	構え
がま	蒲
がま	蝦蟇
かま	窯
かま	構
かま	鎌
かま	釜
かま	竃
かほご	過保護
かほう	家宝
かへんちょう	可変長
かべん	花弁
かへん	可変
がべい	画餅
かへい	貨幣
かべ	壁
かふんしょう	花粉症
かぶん	過分
かぶん	寡聞
かふん	花粉
かぶら	蕪
かぶら	鏑
かふばん	可付番
かぶぬし	株主
かぶと	甲
かぶと	兜
かふちょうせい	家父長制
かふそく	過不足
かぶしきがいしゃ	株式会社
かぶしき	株式
かぶけん	株券
かぶき	歌舞伎
かぶか	株価
かふう	家風
かぶ	蕪
かぶ	被
かぶ	株
かぶ	下部
かふ	寡婦
かふ	下付
かびん	過敏
かびん	花瓶
かひょう	下表
かひつ	加筆
かび	黴
かび	華美
かひ	可否
かはんすう	過半数
かはんしん	下半身
がばん	画板
かばん	鞄
かはん	過半
かばやき	蒲焼き
かばね	姓
かばね	屍
かばしら	蚊柱
がはく	画伯
かば	庇
かば	蒲
かば	樺
かのと	辛
かのじょ	彼女
かのえ	庚
かのうせい	可能性
かのう	可能
かのう	化膿
かねもち	金持ち
かねもうけ	金儲け
かねまわり	金回り
かねづかい	金遣い
かねつ	過熱
かねつ	加熱
かねそなえ	兼ね備え
かねじゃく	曲尺
かねあい	兼ね合い
かね	鐘
かね	兼ね
かね	金
かにゅう	加入
かにく	果肉
かに	蟹
かならずや	必ずや
かならずしも	必ずしも
かならず	必ず
かなもの	金物
かなめ	要
かなで	奏で
かなづち	金槌
かなた	彼方
かなし	悲し
かなし	哀し
かなぐ	金具
かながき	仮名書き
かながき	カナ書き
かなえ	鼎
かない	課内
かない	家内
かなあみ	金網
かな	適
かな	敵
かな	叶
かな	仮名
かとり	蚊取り
かどまつ	門松
かどで	門出
かどち	角地
かどぐち	門口
かどくせい	可読性
かどく	可読
かとく	家督
かとき	過渡期
かどう	華道
かどう	稼働
かとう	過当
かとう	果糖
かとう	加糖
かとう	下等
かど	門
かど	角
かど	過度
かと	過渡
かでん	荷電
かでん	家電
かでん	家伝
かでん	瓜田
かててくわえて	かてて加えて
かていきょうし	家庭教師
かていか	家庭科
かてい	過程
かてい	課程
かてい	家庭
かてい	仮定
かて	糧
かつろ	活路
かつりょく	活力
かつら	桂
かつよう	活用
かつやく	活躍
かっぽうぎ	割烹着
かっぽう	割烹
かつぼう	渇望
がっぺい	合併
かつぶし	鰹節
かっぷく	恰幅
かっぷく	割腹
かっぷ	割賦
がっぴつ	合筆
かっぱん	活版
かっぱつ	活発
かっぱ	合羽
かっぱ	喝破
かっぱ	河童
かつどん	カツ丼
かっとば	かっ飛ば
かつどう	活動
かっとう	葛藤
がっと	ガット
かっと	カット
かって	勝手
がっち	合致
かったつ	闊達
がったい	合体
かっそうろ	滑走路
がっそう	合奏
かっそう	滑走
かっせん	合戦
かつぜつ	滑舌
かっせい	活性
かっすい	渇水
かっしょく	褐色
がっしょうれんこう	合従連衡
がっしょう	合掌
がっしょう	合唱
かつじょう	割譲
がっしゅく	合宿
がっしゅうこく	合衆国
がっしゅうこく	合州国
かっしゃ	滑車
かつじ	活字
がっさん	合算
がっさく	合作
がっさい	合財
かっさい	喝采
かっこく	各国
かっこうほう	滑腔砲
がっこう	学校
かっこう	滑降
かっこう	恰好
かっこう	郭公
かっこう	格好
かっこ	括弧
かっこ	確固
かっこ	各個
かっこ	カッコ
かっけつ	喀血
かっくう	滑空
がっく	楽句
がっく	学区
かっきょく	各局
かっきょう	活況
かっきょ	割拠
がっきゅう	学級
かっきてき	画期的
かつぎこ	かつぎ込
がっき	楽器
がっき	学期
かっき	活気
かっかそうよう	隔靴掻痒
がっかいし	学会誌
がっかい	学界
がっかい	学会
かっかい	各界
かっかい	各回
がっか	学課
がっか	学科
かっか	閣下
かつおぶし	鰹節
かつお	鰹
かつえ	飢え
かつえ	餓え
かつあい	割愛
かつ	担
かつ	且つ
かつ	渇
かつ	活
かっ	渇
かちょうきん	課徴金
がちょう	鵞鳥
かちょう	課長
かちょう	可聴
かちゅう	渦中
かちめ	勝ち目
かちまけ	勝ち負け
かちぼし	勝ち星
かちぬ	勝ち抜
かちと	勝ち取
かちと	かち取
かちすす	勝ち進
かちこし	勝ち越し
かちこ	勝越
かちく	家畜
かちき	勝気
かちかん	価値観
かちあ	かち合
がち	勝ち
かち	価値
かだん	花壇
かだん	歌壇
かたん	荷担
かたん	加担
かたん	下端
かたわら	傍ら
かたりつ	語り継
かたりあ	語り合
かたり	語り
かたら	語ら
かたよ	偏
かたやぶり	型破り
かためん	片面
かため	片目
かため	固め
かため	堅め
かたむ	傾
かたみち	片道
かたみ	片身
かたみ	肩身
かたみ	形見
かたまり	塊
かたま	固ま
かたほう	片方
かたぶつ	堅物
かたばん	型番
かたはば	肩幅
かたはし	片端
かたな	刀
かたとき	片時
かたどおり	型どおり
かたど	模
かたど	象
かたてま	片手間
かたて	片手
かたっぱし	片っ端
かたづけ	片付け
かたづ	片付
かたちづく	形作
かたち	形
かたすみ	片隅
かたず	固唾
かたこり	肩こり
かたこと	片言
かたくるし	堅苦し
かたくりこ	片栗粉
かたくり	片栗
かたくずれ	型くずれ
かたく	家宅
かたく	仮託
かたきうち	敵討ち
かたぎ	堅気
かたぎ	気質
かたがわり	肩代り
かたがわ	片側
かたがみ	型紙
かたかな	片仮名
かたがた	方々
かたがき	肩書
かたおもい	片想い
かたおもい	片思い
かたうで	片腕
かたいれ	肩入れ
がだい	画題
かだい	過大
かだい	課題
かだい	仮題
かたあし	片足
がた	方
がた	型
かた	方
かた	片
かた	難
かた	硬
かた	語
かた	固
かた	肩
かた	堅
かた	形
かた	型
かた	潟
かた	過多
かそくど	加速度
かぞくづれ	家族連れ
かぞく	華族
かぞく	家族
かそく	加速
かぞえ	数え
がぞう	画像
かぞう	家蔵
かそう	火葬
かそう	仮装
かそう	仮想
かそう	下層
かそ	過疎
がせんし	画仙紙
がぜん	俄然
かせん	河川
かせん	架線
かせん	寡占
かせん	化繊
かせん	下線
かぜむき	風向き
かせつ	架設
かせつ	仮説
かせつ	仮設
かせき	化石
かぜい	課税
かせい	家政
かせい	加勢
かせい	仮性
かせい	化成
かぜ	風邪
かぜ	風
かせ	枷
かせ	稼
かずら	葛
かすみ	霞
かずのこ	鯑
かずのこ	数の子
かすたむか	カスタム化
かずすくな	数少な
かずかず	数々
かすが	春日
かすか	微か
かずおおく	数多く
かずおお	数多
かすう	仮数
かすい	下垂
がす	瓦斯
かず	数
かず	下図
かす	掠
かす	粕
かす	糟
かす	霞
かじんはくめい	佳人薄命
がしんしょうたん	臥薪嘗胆
かじん	歌人
かしん	過信
かしん	家臣
かしわもち	柏餅
かしわ	柏
かしら	頭
かしょくのてん	華燭の典
かしょくしょう	過食症
かしょく	過食
かしょく	華燭
かじょうがき	箇条書
がじょう	賀状
がじょう	画帖
がじょう	牙城
がしょう	賀正
がしょう	画商
かじょう	過剰
かじょう	箇条
かしょう	過少
かしょう	過小
かしょう	歌唱
かしょう	仮称
かじょ	加除
かしょ	個所
かしょ	箇所
がしゅう	画集
かじゅう	過重
かじゅう	荷重
かじゅう	果汁
かじゅう	加重
かしゅう	歌集
がしゅ	雅趣
かじゅ	果樹
かしゅ	歌手
かしゃく	呵責
かしや	貸家
かしゃ	貨車
かしまし	姦し
かしま	貸間
かしほん	貸本
かしつけ	貸し付け
がしつ	画質
かじつ	過日
かじつ	果実
かじつ	佳日
かしつ	過失
かしつ	加湿
かしちん	貸賃
かしだし	貸出
かしだ	貸し出
かしこま	畏ま
かしこう	可視光
かしこ	貸し越
かしこ	賢
かしげ	傾げ
かしきん	貸し金
かしきり	貸切り
かしかん	下士官
かしかた	貸方
かじか	鮖
かじか	杜父魚
かじか	鰍
がし	餓死
かじ	鍛冶
かじ	舵
かじ	火事
かじ	家事
かし	瑕疵
かし	貸し
かし	炊
かし	傾
かし	樫
かし	菓子
かし	華氏
かし	河岸
かし	歌詞
かし	可視
かし	仮死
かざんばい	火山灰
かざん	火山
かさん	加算
かざりつけ	飾り付け
かざむき	風向き
かざみどり	風見鶏
かざみ	風見
かさねて	重ねて
かさねがさね	重ね重ね
かさね	重ね
かさな	重な
かざしも	風下
かざぐるま	風車
かさく	寡作
かさく	家作
かさく	佳作
かざかみ	風上
かさいりゅう	火砕流
がざい	画材
がさい	画才
かざい	家財
かさい	火災
かさい	家裁
かざ	飾
かさ	暈
かさ	嵩
かさ	傘
かさ	笠
かごん	過言
かこん	禍根
かこく	過酷
かこく	苛酷
かごうぶつ	化合物
かこうせん	下降線
かこうがん	花崗岩
がごう	雅号
かごう	化合
かこう	火口
かこう	河口
かこう	加工
かこう	下降
かご	籠
かご	篭
かご	加護
かこ	過去
かこ	囲
かげんち	下限値
かげんじょうじょ	加減乗除
かげん	加減
かげん	下限
かげん	下弦
かげろう	陽炎
かけよ	駆寄
かけよ	駆け寄
かけもち	掛持ち
かけも	掛け持
かけまわ	駆け回
かげぼし	陰干し
かけへだて	かけ隔て
かけひき	駆引き
かけひき	駆け引き
かけはなれ	懸離れ
かけはなれ	懸け離れ
かけはなれ	かけ離れ
かけはし	架け橋
かけのぼ	駆け登
かけね	掛け値
かけぬけ	駆け抜け
がけっぷち	崖っ淵
かけつけ	駆けつけ
かけつ	可決
かけだ	駆け出
かけずりまわ	駆けずり回
かけずりまわ	駆けずりまわ
かけず	掛図
かけじく	掛軸
かけざん	掛算
かけざん	掛け算
かけざん	かけ算
かけごと	賭事
かけごえ	かけ声
かけこ	駆け込
かげぐち	陰口
かけきん	掛金
かげき	過激
かげき	歌劇
かけおち	駆落ち
かけおち	駆け落ち
かげえ	影絵
かけいぼ	家計簿
かけい	家計
かけい	家系
かけあわ	掛け合わ
かけあし	駆け足
かけあ	掛け合
がけ	崖
かげ	翳
かげ	影
かげ	陰
かげ	蔭
かけ	翔け
かけ	賭け
かけ	賭
かけ	懸け
かけ	欠け
かけ	駈け
かけ	駆け
かけ	掛け
かけ	架け
がくわり	学割
かくろん	各論
がくれき	学歴
かくれが	隠れ家
かくれ	隠れ
がくりょく	学力
かくりょう	閣僚
かくりつ	確立
かくりつ	確率
かくり	隔離
かくらん	撹乱
かぐら	神楽
がくようひん	学用品
かくゆうごう	核融合
がくゆう	学友
かくやす	格安
かくやく	確約
がくや	楽屋
がくもん	学問
がくめん	額面
かくめん	各面
がくめい	学名
かくめい	革命
がくむ	学務
かくまく	角膜
かくほう	確報
かくほ	確保
かくべつ	格別
かくへき	隔壁
かくへいき	核兵器
かくぶんれつ	核分裂
がくぶち	額縁
がくぶ	学部
がくふ	楽譜
かくぶ	各部
がくひ	学費
かくはん	各般
がくばつ	学閥
かくは	各派
かくのう	格納
がくねん	学年
かくねん	隔年
かくにん	確認
がくない	学内
かくない	閣内
かくとく	獲得
がくどう	楽堂
がくどう	学童
がくどう	学堂
かくとう	確答
かくとう	格闘
かくとう	各党
かくど	角度
かくど	確度
かくてん	各点
かくてん	各店
がくてき	学的
かくてい	確定
かくづけ	格付け
かくつき	各月
かくちょうし	拡張子
がくちょう	学長
かくちょう	格調
かくちょう	拡張
かくちゅう	角柱
かくち	各地
がくだん	楽団
かくだん	格段
がくたい	楽隊
かくだい	拡大
がくそつ	学卒
がくそく	学則
がくそう	学窓
かくそう	各層
かくせんそう	核戦争
がくぜん	愕然
かくぜん	画然
かくせん	各線
がくせつ	学説
かくぜつ	隔絶
がくせき	学籍
かくせいざい	覚醒剤
がくせい	学生
がくせい	学制
かくせい	隔世
かくせい	覚醒
かくせい	拡声
かくすう	画数
かくじん	各人
かくしん	革新
かくしん	確信
かくしん	核心
かくじょし	格助詞
かくしょうちょう	各省庁
がくしょう	楽章
かくしょう	確証
かくしょ	各署
かくしょ	各所
がくじゅつ	学術
がくしゅう	学習
かくじゅう	拡充
かくしゅう	隔週
かくしゅう	確執
かくしゅう	各週
かくしゅ	各種
かくしゃく	矍鑠
がくしゃ	学者
かくしゃ	各社
かくじっけん	核実験
かくじつ	隔日
かくじつ	確実
かくしつ	角質
かくしつ	確執
かくしつ	各室
がくしき	学識
かくしき	格式
がくし	学資
がくし	学士
かくじ	各自
かくし	客死
かくし	各紙
かくし	各市
かくさん	核酸
かくさん	拡散
かくざとう	角砂糖
かくさげ	格下げ
かくさく	画策
がくさい	学才
かくざい	角材
かくさ	格差
かくこう	各項
かくこう	各校
かくご	覚悟
かくげん	確言
かくげん	格言
かくけん	各県
かくげつかん	隔月刊
かくげつ	隔月
がくげき	楽劇
がくげい	学芸
がくぎょう	学業
かくぎ	閣議
かくかぞく	核家族
かくかい	各階
かくか	各課
がくえん	学園
かくえき	各駅
かくうんどうりょう	角運動量
かくう	架空
がくいん	学院
かくいん	客員
かくいん	各員
かくいつてき	画一的
がくい	学位
かくい	各位
かくあげ	格上げ
がく	額
がく	学
かぐ	家具
かく	角
かく	確
かく	殻
かく	核
かく	格
かく	各
かく	画
かく	隠
かきん	課金
かきわけ	かき分け
かぎりな	限りな
かきよせ	かき寄せ
かきょく	歌曲
かぎょう	稼業
かぎょう	家業
かきょう	華僑
かきょう	架橋
かきょう	家教
かきょう	佳境
かきゅう	火急
かきゅう	下級
かきゃくせん	貨客船
かぎゃく	苛虐
かぎゃく	可逆
かぎゃく	加虐
かきみだ	かき乱
かきまわ	かき回
かきまぜ	かき混ぜ
かきのこ	書き残
かきね	垣根
かきぬ	書き抜
かきとり	書取
かきとめ	書留
かきとめ	書き留め
かきと	書き取
かきつらね	書き連ね
かきつばた	杜若
かきつけ	書付け
かきつけ	書き付け
かきたて	書き立て
かきだ	書き出
かきぞめ	書初め
かきそえ	書き添え
かきこみけん	書き込み権
かきこ	書き込
かきけ	かき消
かきくだ	書き下
かぎかっこ	鈎括弧
かきかた	書き方
かきかえ	書換え
かきかえ	書き換え
かきおろ	書き下ろ
かきおと	書き落と
かきおき	書置
かきお	書き置
かきいれどき	書き入れ時
かきいれ	書き入れ
かきあらわ	書き表
かきあつめ	かき集め
かきあげ	書き上げ
かきあげ	かき揚げ
かぎ	限
かぎ	鍵
かぎ	鈎
かき	堵
かき	蛎
かき	柿
かき	垣
かき	花卉
かき	花器
かき	火気
かき	夏季
かき	夏期
かき	下記
かき	牡蛎
かかんそく	可観測
かかん	果敢
かかわ	拘
かかわ	係わ
かかわ	関わ
かかわ	関
かかりちょう	係長
かかりかん	係官
かかりいん	係員
かかり	係
かがやかし	輝かし
かがやか	輝か
かがや	輝
かがみ	鏡
かかと	踵
かかし	案山子
かかげ	掲げ
ががく	雅楽
かがく	科学
かがく	化学
かかく	価格
かかえ	抱え
がかい	瓦解
かがい	課外
かがい	加害
かかい	下界
がか	画家
かが	屈
かか	懸か
かか	欠か
かか	係
かか	掛か
かか	架か
かおやく	顔役
かおむけ	顔向け
かおみしり	顔見知り
かおぶれ	顔ぶれ
かおだち	顔立ち
かおく	家屋
かおいろ	顔色
かおあわせ	顔合せ
かお	香
かお	薫
かお	顔
がえんじ	肯んじ
がえん	肯ん
かえん	火焔
かえん	火炎
かえる	蛙
かえりみ	省み
かえりみ	顧み
かえりざき	返咲き
かえりざ	返り咲
がえり	帰り
かえで	楓
かえって	却って
かえだま	替玉
かえ	返
かえ	変え
かえ	代え
かえ	替え
かえ	帰
かえ	換え
かいん	下院
かいわい	界隈
かいわ	会話
がいろん	概論
かいろう	回廊
がいろ	街路
かいろ	海路
かいろ	懐炉
かいろ	回路
かいれい	海嶺
がいりん	外輪
がいりょく	外力
かいりょう	改良
かいりゅう	海流
がいりゃく	概略
かいりく	海陸
かいり	乖離
がいらん	外乱
かいらん	回覧
かいらく	快楽
がいらい	外来
かいらい	傀儡
がいよう	概要
かいよう	潰瘍
かいよう	海洋
がいゆう	外遊
かいゆう	回遊
かいゆ	快癒
かいやく	改訳
かいやく	解約
がいや	外野
かいもん	開門
かいもの	買物
かいもの	買いもの
かいもど	買い戻
かいもく	皆目
がいめん	外面
かいめん	界面
かいめん	海面
かいめん	海棉
かいめつ	壊滅
かいめい	開明
かいめい	改名
かいめい	解明
がいむ	外務
かいむ	皆無
かいむ	会務
かいみん	快眠
かいまみ	かいま見
かいまく	開幕
がいまい	外米
かいぼう	解剖
かいほう	開放
かいほう	快方
かいほう	解放
かいほう	会報
かいほう	介抱
かいへん	改編
かいへん	改変
がいへき	外壁
かいぺーじ	改ページ
かいへい	開閉
かいへい	開平
かいぶんしょ	怪文書
がいぶん	外聞
かいぶつ	怪物
かいふく	快復
かいふく	回復
かいふう	開封
がいぶ	外部
かいふ	回付
かいひん	海浜
がいひょう	概評
かいひょう	開票
かいびゃく	開闢
かいひふく	開被覆
がいひ	外皮
かいび	快美
かいひ	回避
かいひ	会費
かいはん	改版
かいはつぶ	開発部
かいばつ	海抜
かいはつ	開発
かいはくしょく	灰白色
がいはく	外泊
かいはい	改廃
がいねん	概念
かいね	買値
かいぬし	飼い主
かいにん	懐妊
かいにん	解任
かいにゅう	介入
かいなん	海難
かいなら	飼い慣ら
がいどく	害毒
かいどく	買い得
かいどく	解読
がいとう	該当
がいとう	街頭
がいとう	街灯
がいとう	外灯
かいどう	街道
かいどう	会堂
かいとう	回答
かいとう	解答
かいとう	解凍
かいとう	会頭
がいど	ガイド
かいと	買い取
がいでん	外電
がいでん	外伝
かいでん	皆伝
かいてん	開店
かいてん	回転
がいてき	外的
がいてき	外敵
かいてき	快適
かいてい	階梯
かいてい	開廷
かいてい	海底
かいてい	改訂
かいてい	改定
かいて	買い手
かいつけ	買付け
かいづか	貝塚
かいつう	開通
かいちょう	階調
かいちょう	快調
かいちょう	会長
がいちゅう	害虫
がいちゅう	外注
かいちゅう	海中
かいちゅう	懐中
かいちく	改築
がいたん	慨嘆
かいだん	階段
かいだん	怪談
かいだん	会談
がいためほう	外為法
かいだめ	買い溜め
かいだく	快諾
かいたく	開拓
かいだい	改題
かいだい	解題
かいたい	懐胎
かいたい	解体
かいぞく	海賊
かいそく	快速
かいそく	会則
かいぞうど	解像度
がいそう	外挿
がいそう	外層
かいぞう	改造
かいそう	階層
かいそう	海藻
かいそう	海草
かいそう	改装
かいそう	快走
かいそう	回送
かいそう	回想
かいそう	会葬
かいそ	開祖
かいそ	改組
がいせん	外線
がいせん	凱旋
かいぜん	改善
かいせん	開戦
かいせん	改選
かいせん	回線
かいせん	回旋
かいせん	会戦
がいせつ	概説
がいせつ	外接
かいせつ	開設
かいせつ	解説
がいせき	外積
がいせき	外戚
かいせき	懐石
かいせき	解析
かいせき	会席
がいせい	外声
がいせい	外征
かいせい	改正
かいせい	改姓
かいせい	快晴
かいせい	回生
がいすう	概数
かいすう	階数
かいすう	回数
かいすいよく	海水浴
かいすい	海水
かいしんげき	快進撃
がいじん	外人
がいしん	外心
がいしん	外信
かいしん	改新
かいしん	改心
かいしん	回診
かいしん	会心
がいしょく	外食
かいしょく	解職
かいしょく	会食
がいしょう	外相
がいしょう	外傷
かいじょう	階上
かいじょう	開場
かいじょう	海上
かいじょう	会場
かいしょう	甲斐性
かいしょう	改称
かいしょう	解消
かいじょ	解除
かいしょ	楷書
かいしょ	会所
かいしゅん	改悛
かいしゅん	回春
がいしゅつ	外出
かいしゅうごう	開集合
がいしゅう	外周
かいじゅう	晦渋
かいじゅう	懐柔
かいじゅう	怪獣
かいしゅう	改修
かいしゅう	回収
がいじゅ	外需
かいしゃく	解釈
かいしゃく	介錯
かいしゃいん	会社員
がいしゃ	外車
がいしゃ	会社
かいしゃ	会社
かいしめ	買占め
かいしめ	買い占め
かいしつ	開室
がいじ	外字
がいし	碍子
がいし	外資
がいし	外紙
かいじ	開示
かいじ	快事
かいし	開始
かいし	会誌
かいさんぶつ	海産物
がいさん	概算
かいざん	海山
かいざん	改竄
かいさん	解散
かいさつ	改札
かいさく	改作
がいざい	外材
がいさい	外債
かいざい	介在
かいさい	開催
かいさ	階差
かいこん	開墾
かいこん	悔恨
がいこつ	骸骨
がいこく	外国
かいこく	開国
かいこく	悔告
がいこうかん	外交官
がいこう	外向
がいこう	外交
かいごう	会合
かいこう	邂逅
かいこう	開港
かいこう	開校
かいこう	海溝
かいこう	海港
かいこう	改稿
かいこう	回航
がいご	外語
かいご	介護
かいこ	買い込
かいこ	蚕
かいこ	懐古
かいこ	回顧
かいこ	解雇
かいげんれい	戒厳令
がいけん	外見
かいげん	改元
かいげん	戒厳
かいけん	改憲
かいけん	会見
かいけつさく	解決策
かいけつ	解決
がいけい	外形
かいけい	会計
かいぐん	海軍
かいぐい	買い食い
がいきん	外勤
かいきん	開襟
かいきん	皆勤
かいきん	解禁
がいきょく	外局
かいきょく	開局
かいぎょうい	開業医
がいきょう	概況
かいぎょう	開業
かいぎょう	改行
かいきょう	海峡
かいきょう	回教
かいきょ	快挙
かいきゅう	階級
かいきゅう	懐旧
かいぎゃく	諧謔
かいきせん	回帰線
かいきしょく	皆既食
がいき	外気
かいぎ	懐疑
かいぎ	会議
かいき	買い切
かいき	皆既
かいき	怪奇
かいき	快気
かいき	回帰
かいき	回忌
かいき	会期
かいがんせん	海岸線
がいかん	概観
がいかん	外観
がいかん	外患
かいがん	開眼
かいがん	海岸
かいかん	開館
かいかん	快感
かいかん	会舘
かいかん	会館
かいがら	貝殻
がいかつ	概括
かいかつ	快活
かいかけ	買掛
がいかく	外郭
がいかく	外角
かいかく	改革
かいかえ	買い替え
がいかい	外界
かいがい	海外
かいかい	開会
がいか	外貨
がいか	凱歌
かいが	絵画
かいか	階下
かいか	開花
かいか	開化
かいおき	買い置き
がいえん	外縁
がいえん	外延
かいえん	開演
かいえん	開宴
かいえん	開園
かいうん	開運
かいうん	海運
かいいんせい	会員制
がいいん	外因
かいいん	開院
かいいん	海員
かいいん	改印
かいいん	会員
かいいれ	買い入れ
かいいき	海域
かいい	魁偉
かいい	怪異
がいあつ	外圧
かいあげ	買い上げ
がいあく	害悪
かいあく	改悪
がい	該
がい	概
がい	害
かい	甲斐
かい	貝
かい	階
かい	界
かい	怪
かい	回
かい	解
かい	会
かい	介
かい	下位
かあちゃん	母ちゃん
かあさん	母さん
が	駕
が	賀
が	蛾
が	臥
が	画
が	我
か	描
か	買
か	貸
か	掻
か	勝
か	書
か	狩
か	飼
か	香
か	欠
か	駆
か	苅
か	刈
か	噛
か	穫
か	蚊
か	課
か	架
か	果
か	科
か	嫁
か	可
か	化
おんわ	穏和
おんわ	温和
おんれい	御礼
おんりょう	音量
おんよみ	音読み
おんよく	温浴
おんみょう	陰陽
おんみつ	隠密
おんぷう	温風
おんぷ	音符
おんびん	音便
おんびん	穏便
おんぱ	音波
おんねん	怨念
おんねつ	温熱
おんならし	女らし
おんなのこ	女の子
おんな	女
おんどけい	温度計
おんとう	穏当
おんど	音頭
おんど	温度
おんてん	恩典
おんてい	音程
おんちゅう	御中
おんち	音痴
おんだん	温暖
おんたい	温帯
おんぞん	温存
おんそく	音速
おんぞうし	御曹司
おんぞう	音像
おんそ	音素
おんせつ	音節
おんせい	音声
おんすい	温水
おんじん	恩人
おんしん	音信
おんじょう	音声
おんじょう	温情
おんしょう	温床
おんしょう	恩賞
おんじゅん	温順
おんしゃ	御社
おんしゃ	恩赦
おんしつ	音質
おんしつ	温室
おんし	恩賜
おんし	恩師
おんこう	温厚
おんこ	恩顧
おんけん	穏健
おんけい	恩恵
おんきょう	音響
おんきゅう	恩給
おんかん	音感
おんがく	音楽
おんがえし	恩返し
おんかい	音階
おんいん	音韻
おん	音
おん	恩
おわり	終
おわび	お詫び
おわい	汚穢
おわ	終わ
おわ	終
おろそか	疎か
おろしね	卸値
おろしそうば	卸相場
おろしうり	卸売
おろし	卸
おろかし	愚かし
おろか	愚か
おろ	降ろ
おろ	下ろ
おろ	卸
おれまが	折れ曲が
おれたち	俺達
おれせん	折れ線
おれい	御礼
おれい	お礼
おれ	折れ
おれ	俺
おりもの	織物
おりめ	折り目
おりたた	折り畳
おりしも	折しも
おりこみ	折込
おりこ	折り込
おりこ	織り込
おりがみ	折り紙
おりかさな	折り重な
おりかえ	折り返
おりおり	折々
おりあ	折り合
おり	檻
おり	澱
おり	折
おり	降り
おり	下り
およろこび	お慶び
およろこび	お喜び
おより	お撚り
およぼ	及ぼ
およびごし	及び腰
および	及び
および	お呼び
およ	及
およ	泳
おゆるし	お許し
おゆき	お逝き
おゆ	お湯
おやゆび	親指
おやもと	親元
おやぶん	親分
おやふこう	親不孝
おやばか	親馬鹿
おやだま	親玉
おやじ	親父
おやこうこう	親孝行
おやこ	親子
おやくそく	お約束
おやかた	親方
おや	親
おもんぱか	慮
おもん	重ん
おもわず	思わず
おもわし	思わし
おもわく	思惑
おもり	錘
おもり	重り
おもや	母屋
おももち	面持ち
おもむき	趣
おもむ	赴
おもみ	重み
おもはゆ	面映
おもね	阿
おもに	重荷
おもに	主に
おもてむき	表向き
おもてじ	表地
おもてぐち	表口
おもてがわ	表側
おもてがき	表書き
おもて	面
おもて	表
おもちゃ	玩具
おもた	重た
おもしろ	面白
おもざし	面差し
おもくるし	重苦し
おもかげ	面影
おもおもし	重々し
おもうしこみ	お申し込み
おもいや	思いや
おもいのこ	思い残
おもいなお	思い直
おもいで	想い出
おもいで	思い出
おもいつめ	思い詰め
おもいつ	思い付
おもいつ	思いつ
おもいちがい	思い違い
おもいだ	思い出
おもいだ	思いだ
おもいた	思い立
おもいし	思い知
おもいこ	思い込
おもいきや	思いきや
おもいき	思い切
おもいがけな	思いがけな
おもいかえ	思い返
おもいおこ	思い起こ
おもいいた	思い至
おもいあた	思い当た
おも	想
おも	重
おも	主
おも	思
おめにかか	お目にかか
おめいし	お名刺
おめい	汚名
おみまい	御見舞
おみまい	お見舞
おみき	お神酒
おまわり	お巡り
おまもり	お守り
おまつり	お祭り
おまち	お待ち
おまごさん	お孫さん
おまえ	お前
おまいり	御参り
おまいり	お参り
おぼろ	朧ろ
おぼれ	溺れ
おぼし	思し
おぼえがき	覚書
おぼえ	覚え
おぼえ	憶え
おへんじ	御返事
おへんじ	お返事
おへや	お部屋
おふれ	お触れ
おぶつ	汚物
おひろめ	お披露目
おひれ	尾ひれ
おびやか	脅か
おひとよし	御人好し
おひとよし	お人好し
おびただし	夥し
おびじょう	帯状
おひさしぶり	お久しぶり
おひきたて	お引き立て
おひきうけ	お引受け
おび	帯び
おび	帯
おはなし	お話
おばけ	お化け
おばあさん	お婆さん
おば	伯母
おば	小母
おば	叔母
おのれ	己
おのずと	自ずと
おのずから	自ずから
おのおの	各々
おの	斧
おねたみ	お妬み
おねがい	お願い
おねえさん	お姉さん
おね	尾根
おにいさん	お兄さん
おに	鬼
おなまえ	お名前
おなじよう	同じよう
おなじみ	お馴染み
おなじく	同じく
おなじ	同じ
おながどり	尾長鶏
おなが	尾長
おなか	お腹
おないどし	同い年
おどろか	驚か
おとろえ	衰え
おどろ	驚
おとりひき	お取り引き
おとりはからい	お取り計らい
おとりしらべ	お取り調べ
おとりこみちゅう	お取り込み中
おとりあつかい	お取扱い
おとりあつかい	お取り扱い
おとめ	乙女
おとなび	大人び
おとなし	大人し
おとなげな	大人げな
おとな	大人
おととし	一昨年
おととい	一昨日
おとづれ	訪れ
おとしもの	落し物
おとしいれ	陥れ
おとし	お年
おとさた	音沙汰
おとこらし	男らし
おとこのこ	男の子
おとこで	男手
おとこ	男
おどか	脅か
おとうと	弟
おとうさん	お父さん
おど	踊
おど	躍
おど	脅
おと	劣
おと	落と
おと	落
おと	音
おでんわ	お電話
おてん	汚点
おてまえ	お点前
おてま	お手間
おてほん	お手本
おてすう	お手数
おでかけ	お出かけ
おてあげ	お手上げ
おっと	夫
おって	追手
おって	追っ手
おって	追って
おつつしみ	お慎み
おつつしみ	お謹み
おつたえ	お伝え
おっこち	落っこち
おつげ	お告げ
おっくう	億劫
おつぎ	お接ぎ
おつき	お附き
おっかけ	追っかけ
おつかい	お使い
おつ	乙
おちゅうげん	御中元
おちゃ	お茶
おちぶれ	落ちぶれ
おちば	落葉
おちど	落度
おちつ	落ち着
おちこ	落ち込
おちい	陥
おちあ	落ち合
おち	落ち
おち	墜ち
おち	堕ち
おたより	お便り
おだやか	穏やか
おだて	煽て
おたっし	お達し
おたち	お発ち
おたち	お裁ち
おたずね	お尋ね
おたけび	雄叫び
おだく	汚濁
おたがいに	お互いに
おたがい	お互い
おそん	汚損
おそわ	教わ
おそろし	恐ろし
おそろいで	お揃いで
おそれながら	恐れながら
おそれい	恐れ入
おそれ	虞
おそれ	恐れ
おそるべき	恐るべき
おそらし	お反らし
おそらくは	恐らくは
おそらく	恐らく
おぞまし	悍まし
おぞまし	鈍まし
おそし	遅し
おそざき	遅咲き
おそくとも	遅くとも
おそ	遅
おそ	襲
おせん	汚染
おせわ	お世話
おせっかい	お節介
おせいぼ	御歳暮
おすみつき	お墨付き
おすまい	お住い
おすい	汚水
おす	雄
おす	牡
おしんこ	お新香
おしろい	白粉
おしらせ	お知らせ
おしよせ	押し寄せ
おしょくじ	お食事
おじょく	汚辱
おじょうさん	お嬢さん
おじょうさま	お嬢様
おしょう	和尚
おしゃれ	お洒落
おしむらくは	惜しむらくは
おしみな	惜しみな
おしはか	推し量
おしのけ	押し退け
おしどり	鴛鴦
おしとお	押し通
おしつま	押し詰ま
おしつけ	押し付け
おしつけ	押しつけ
おしだ	押し出
おしずまり	お鎮まり
おしこめ	押し込め
おしごと	お仕事
おしこ	押し込
おしくも	惜しくも
おしき	押し切
おしかけ	押しかけ
おしかえ	押し返
おしえ	教え
おしうり	押売
おしいれ	押入
おじいさん	お爺さん
おしい	押し入
おしあわせ	お幸せ
おしあげ	押し上げ
おじ	伯父
おじ	小父
おじ	叔父
おし	惜し
おし	押し
おさめ	納め
おさめ	修め
おさめ	収め
おさめ	治め
おさま	納ま
おさま	修ま
おさま	収ま
おさま	治ま
おさなご	幼子
おさな	幼
おさそい	お誘い
おさきに	お先に
おさえこ	抑え込
おさえこ	押え込
おさえ	抑え
おさえ	押さえ
おさえ	押え
おこな	行な
おこな	行
おことわり	お断わり
おことわり	お断り
おこたえ	お答え
おこた	怠
おごそか	厳か
おこし	お越し
おこさん	お子さん
おこさま	お子様
おこ	怒
おこ	興
おこ	起こ
おけいこ	お稽古
おけ	桶
おくればせながら	遅ればせながら
おくれ	遅れ
おくれ	後れ
おくりもの	贈物
おくりむかえ	送り迎え
おくりぬし	送り主
おくりとどけ	送り届け
おくりだ	送り出
おくりじょう	送り状
おくりさき	送り先
おくりこ	送り込
おくりがな	送り仮名
おくらせ	遅らせ
おぐら	小倉
おくら	遅ら
おくゆき	奥行き
おくゆかし	奥ゆかし
おくやみ	お悔やみ
おくやま	奥山
おくめん	臆面
おくびょう	臆病
おくば	奥歯
おくにがら	お国柄
おくない	屋内
おくち	奥地
おくそこ	奥底
おくそく	憶測
おくじょう	屋上
おくさん	奥さん
おくさま	奥様
おくぎ	奥義
おくがい	屋外
おく	贈
おく	送
おく	臆
おく	億
おく	奥
おきわすれ	置き忘れ
おきゃくさま	お客様
おきゃく	お客
おきもの	置物
おきもち	お気持
おきば	置場
おきにいり	お気に入り
おぎな	補
おきな	翁
おきて	掟
おきざり	置き去り
おきかわ	置き換わ
おきかえ	置換え
おきかえ	置き換え
おきあが	起き上が
おきあい	沖合い
おぎ	荻
おき	起き
おき	沖
おかん	悪寒
おかわり	お変わり
おかわり	お変り
おかわり	お代り
おがわ	小川
おかり	お狩り
おかり	お刈り
おかもち	岡持ち
おかぼ	陸稲
おかね	お金
おかどちがい	お門違い
おかっぴき	岡っ引き
おかって	お勝手
おかじょうき	陸蒸気
おかし	可笑し
おかげん	お加減
おかげさま	御蔭様
おかげさま	お蔭様
おかげ	御蔭
おかげ	お蔭
おかえし	お返し
おかあさん	お母さん
おかあさま	お母様
おが	拝
おか	冒
おか	犯
おか	侵
おか	丘
おか	岡
おおわらわ	大童
おおわらい	大笑い
おおゆき	大雪
おおやま	大山
おおやすうり	大安売り
おおやけ	公
おおや	大家
おおもり	大盛り
おおもの	大物
おおもと	大本
おおもじ	大文字
おおめ	大目
おおむね	概ね
おおむかし	大昔
おおみそか	大晦日
おおみず	大水
おおまちがい	大間違い
おおまた	大股
おおまがり	大曲
おおまか	大まか
おおびけ	大引け
おおばん	大判
おおはば	大幅
おおはし	大橋
おおなみ	大波
おおとり	鵬
おおとり	鳳
おおとり	鴻
おおどしま	大年増
おおどおり	大通り
おおで	大手
おおづめ	大詰め
おおたき	大滝
おおぞら	大空
おおせつか	仰せつか
おおぜき	大関
おおぜい	大勢
おおせ	仰せ
おおずもう	大相撲
おおすじ	大筋
おおしま	大島
おおし	雄々し
おおさわぎ	大騒ぎ
おおさめ	お納め
おおざっぱ	大雑把
おおごえ	大声
おおげさ	大袈裟
おおげさ	大げさ
おおくり	お送り
おおくら	大蔵
おおくもの	多くもの
おおぐち	大口
おおくち	大口
おおく	多く
おおきに	大きに
おおきな	大きな
おおき	大き
おおかわ	大川
おおかみ	狼
おおがたき	大型機
おおがた	大形
おおがた	大型
おおかた	大方
おおかぜ	大風
おおがかり	大掛かり
おおがかり	大がかり
おおおとこ	大男
おおうりだし	大売出し
おおいり	大入
おおいに	大いに
おおいなる	大いなる
おおいそぎ	大急ぎ
おおいし	大石
おおい	大い
おおあめ	大雨
おお	覆
おお	被
おお	多
おえらがた	お偉方
おえつ	嗚咽
おえかき	お絵書き
おえ	終え
おうろ	往路
おうりょく	応力
おうりょう	横領
おうらい	往来
おうよう	鷹揚
おうよう	応用
おうむ	鸚鵡
おうぼう	横暴
おうほう	応報
おうぼ	応募
おうへん	黄変
おうへい	横柄
おうぶん	欧文
おうふく	往復
おうふう	欧風
おうひ	王妃
おうはん	凹版
おうのう	懊悩
おうねん	往年
おうなつ	押捺
おうとつ	凹凸
おうどう	黄銅
おうどう	王道
おうとう	応答
おうどいろ	黄土色
おうてん	横転
おうて	王手
おうちょう	王朝
おうちゃく	横着
おうち	樗
おうだん	横断
おうだく	応諾
おうたい	応対
おうせん	応戦
おうせつ	応接
おうせい	王制
おうせい	旺盛
おうしん	往診
おうしん	往信
おうしょく	黄色
おうじょう	往生
おうしょう	王将
おうしゅう	押収
おうしゅう	応酬
おうじゃ	王者
おうしつ	王室
おうじ	王子
おうじ	往時
おうし	牡牛
おうさま	王様
おうさつ	応札
おうざ	王座
おうごん	黄金
おうこく	王国
おうこう	王侯
おうこう	横行
おうけとり	お受け取り
おうきゅう	王宮
おうきゅう	応急
おうぎ	扇
おうかん	王冠
おうかん	往還
おうかくまく	横隔膜
おうか	桜花
おうか	欧化
おうか	押下
おうおうにして	往々にして
おうおう	往々
おうえん	応援
おういん	押韻
おういん	押印
おういつ	横溢
おうい	王位
おう	王
おう	応
おいわい	御祝い
おいわい	お祝い
おいる	オイル
おいもとめ	追い求め
おいめ	負い目
おいぼれ	老いぼれ
おいはら	追い払
おいのり	お祈り
おいぬ	追い抜
おいつめ	追い詰め
おいつ	追い付
おいたて	追い立て
おいたて	追いたて
おいたち	生い立ち
おいだ	追い出
おいそがしい	お忙しい
おいしげ	生い茂
おいし	美味し
おいこ	老い込
おいこ	追い込
おいこ	追い越
おいこ	追いこ
おいかけまわ	追い掛け回
おいかけまわ	追いかけ回
おいかけ	追い掛け
おいかけ	追いかけ
おい	老い
おい	甥
おあらため	お改め
おあいて	御相手
おあいて	お相手
お	負
お	尾
お	追
お	逐
お	置
お	折
お	推
お	織
お	緒
お	居
お	押
お	於
お	圧
えんろ	遠路
えんりょ	遠慮
えんらい	遠来
えんよう	遠洋
えんよう	援用
えんやす	円安
えんもく	演目
えんめい	延命
えんむすび	縁結び
えんまん	円満
えんまちょう	閻魔帳
えんまく	煙幕
えんぽう	遠方
えんぶん	塩分
えんぶん	艶聞
えんびふく	燕尾服
えんぴつ	鉛筆
えんび	塩ビ
えんばん	円盤
えんのした	縁の下
えんねつ	炎熱
えんにち	縁日
えんとつ	煙突
えんどお	縁遠
えんどう	沿道
えんとう	円筒
えんてんか	炎天下
えんちょく	鉛直
えんちょう	延長
えんちょう	園長
えんちゅう	円柱
えんちゃく	延着
えんだん	縁談
えんだん	演壇
えんたく	円卓
えんだか	円高
えんたい	延滞
えんそく	遠足
えんそう	演奏
えんぜん	艶然
えんせん	沿線
えんぜつ	演説
えんせき	宴席
えんせい	遠征
えんせい	延性
えんせい	厭世
えんすいだい	円錐台
えんずい	延髄
えんすい	円錐
えんしんりょく	遠心力
えんじん	円陣
えんじょう	炎上
えんしょう	炎症
えんしょう	延焼
えんじょ	援助
えんしゅつ	演出
えんじゅくみ	円熟味
えんじゅく	円熟
えんしゅう	演習
えんしゅう	円周
えんじゃく	燕雀
えんじゃ	縁者
えんじ	演じ
えんじ	園児
えんし	遠視
えんざん	演算
えんさん	塩酸
えんさ	怨嗟
えんこん	怨恨
えんご	援護
えんご	掩護
えんこ	縁故
えんこ	円弧
えんげき	演劇
えんげい	演芸
えんげい	園芸
えんけい	遠景
えんけい	円形
えんきん	遠近
えんきょり	遠距離
えんぎ	縁起
えんぎ	演技
えんき	延期
えんがん	沿岸
えんかん	円環
えんがわ	縁側
えんかつ	円滑
えんかくち	遠隔地
えんかく	遠隔
えんかく	沿革
えんかい	遠海
えんかい	沿海
えんかい	宴会
えんか	塩化
えんか	演歌
えんえん	延々
えんえき	演繹
えんえい	遠泳
えん	塩
えん	苑
えん	縁
えん	演
えん	宴
えん	園
えん	円
えりもと	襟元
えりぬき	選り抜き
えりぬ	えり抜
えりくび	襟首
えり	襟
えり	衿
えらぶ	偉ぶ
えらびだ	選び出
えら	鰓
えら	選
えら	撰
えら	偉
えもの	獲物
えまき	絵巻
えま	絵馬
えほん	絵本
えぼし	烏帽子
えふだ	絵札
えびちゃ	葡萄茶
えびす	胡
えびす	恵比須
えびす	恵比寿
えびす	夷
えび	鰕
えび	海老
えび	蝦
えばら	荏原
えはがき	絵はがき
えのぐ	絵の具
えのき	榎
えにし	縁
えどま	江戸間
えとく	会得
えと	干支
えてして	得てして
えて	得手
えつらん	閲覧
えつらく	悦楽
えつねん	越年
えっとう	越冬
えっけん	越権
えっけん	謁見
えづけ	餌付け
えっきょう	越境
えだみち	枝道
えだまめ	枝豆
えだぶり	枝振り
えだは	枝葉
えたい	得体
えだ	枝
えしゃく	会釈
えじき	餌食
えし	絵師
えさ	餌
えきり	疫痢
えきめい	駅名
えきむ	役務
えきまえどおり	駅前通り
えきまえ	駅前
えきびょう	疫病
えきでん	駅伝
えきちょう	駅長
えきたい	液体
えきせい	液性
えきじょう	液状
えきしょう	液晶
えきしゃ	易者
えきがく	疫学
えきか	液化
えきいん	駅員
えき	役
えき	駅
えき	益
えき	液
えき	易
えがら	絵柄
えがお	笑顔
えが	描
えいわ	英和
えいりんしょ	営林署
えいりん	映倫
えいりん	営林
えいり	鋭利
えいり	営利
えいようそ	栄養素
えいようし	栄養士
えいようか	栄養価
えいよう	栄養
えいゆう	英雄
えいやく	英訳
えいめい	英明
えいみん	永眠
えいぶん	英文
えいびん	鋭敏
えいねん	永年
えいてん	栄転
えいち	英知
えいち	叡智
えいだん	英断
えいだん	営団
えいたん	詠嘆
えいたつ	栄達
えいぞく	永続
えいぞう	映像
えいぞう	営造
えいぜん	営繕
えいせいし	衛生士
えいせい	衛生
えいせい	衛星
えいせい	永逝
えいせい	永世
えいしん	栄進
えいじゅう	永住
えいしゃき	映写機
えいしゃ	映写
えいじ	英字
えいじ	映じ
えいじ	嬰児
えいさい	英才
えいこせいすい	栄枯盛衰
えいごう	永劫
えいこう	栄光
えいこう	曳航
えいこう	曳光
えいぎょうぶ	営業部
えいぎょうちゅう	営業中
えいぎょうか	営業課
えいぎょう	営業
えいきょう	影響
えいきゅうし	永久歯
えいきゅう	永久
えいき	鋭気
えいかん	栄冠
えいかく	鋭角
えいがかん	映画館
えいが	栄華
えいが	映画
えいえん	永遠
えいい	鋭意
えい	詠
えい	栄
えい	映
え	柄
え	得
え	選
え	笑
え	獲
え	絵
え	画
え	餌
うんりょう	雲量
うんよう	運用
うんゆ	運輸
うんめい	運命
うんぴつ	運筆
うんぱん	運搬
うんぬん	云々
うんどんこん	運鈍根
うんどうりょう	運動量
うんどうじょう	運動場
うんどうかい	運動会
うんどう	運動
うんてんしゅ	運転手
うんてん	運転
うんでい	雲泥
うんちん	運賃
うんちく	蘊蓄
うんそうや	運送屋
うんそう	運送
うんせい	運勢
うんしん	運針
うんざん	運算
うんさん	雲散
うんこう	運行
うんこう	運航
うんきゅう	運休
うんかい	雲海
うんが	運河
うんえい	運営
うん	雲
うん	運
うん	云
うわやく	上役
うわめ	上目
うわむき	上向き
うわむ	上向
うわまわ	上回
うわまえ	上前
うわべ	上辺
うわばき	上履き
うわのせ	上乗せ
うわぬり	上塗り
うわづみ	上積み
うわすべり	上滑り
うわさ	噂
うわぐつ	上靴
うわぐすり	釉
うわぎ	上着
うわき	浮気
うわがわ	上側
うわがき	上書き
うろん	胡乱
うろこ	鱗
うろおぼえ	うろ覚え
うろ	迂路
うれゆき	売行き
うれのこ	売れ残
うれっこ	売れっ子
うれし	嬉し
うれくち	売れ口
うれえ	憂え
うれえ	愁え
うれい	憂い
うれい	愁い
うれ	熟れ
うるわしの	麗しの
うるわし	麗し
うるちまい	粳米
うるち	粳
うるし	漆
うるさ	煩
うるさ	五月蝿
うるお	潤
うるうどし	閏年
うるう	閏
うりわた	売り渡
うりょう	雨量
うりはら	売り払
うりば	売場
うりね	売値
うりぬし	売り主
うりぬけ	売り抜け
うりて	売り手
うりだし	売出
うりだ	売り出
うりこ	売子
うりこ	売り込
うりきれ	売り切れ
うりかけきん	売掛金
うりかけ	売り掛け
うりかい	売り買い
うりあげだか	売上高
うりあげきん	売上金
うりあげ	売上
うりあげ	売り上げ
うり	瓜
うらん	ウラン
うららか	麗らか
うらやまし	羨まし
うらやま	裏山
うらや	羨
うらめし	恨めし
うらめ	裏目
うらみち	裏道
うらまち	裏町
うらはら	裏腹
うらにわ	裏庭
うらない	卦
うらな	占
うらて	裏手
うらづけ	裏付け
うらじ	裏地
うらさびし	うら寂し
うらさく	裏作
うらぐち	裏口
うらぎ	裏切
うらがわ	裏側
うらがね	裏金
うらがなし	うら悲し
うらかた	裏方
うらがき	裏書
うらがえ	裏返
うらおもて	裏表
うら	裡
うら	裏
うら	恨
うら	怨
うら	浦
うよく	右翼
うよ	紆余
うやま	敬
うやうやし	恭し
うもれ	埋もれ
うもう	羽毛
うめみ	梅見
うめぼし	梅干し
うめぼし	梅干
うめたてち	埋立地
うめたて	埋立
うめたて	埋め立て
うめしゅ	梅酒
うめこ	埋め込
うめあわせ	埋め合わせ
うめあわせ	埋め合せ
うめ	呻
うめ	埋め
うめ	梅
うむ	有無
うみべ	海辺
うみどり	海鳥
うみだ	生み出
うみぞい	海沿い
うみせんやません	海千山千
うみおと	産み落と
うみ	膿
うみ	海
うまれつき	生まれつき
うまれかわ	生まれ変わ
うまれ	生まれ
うまれ	産まれ
うまや	厩
うまみ	旨味
うまぬし	馬主
うまに	甘煮
うまどし	午年
うまづら	馬面
うま	埋ま
うま	馬
うま	旨
うま	午
うへん	右辺
うぶゆ	産湯
うぶすな	産土
うぶごえ	産声
うぶげ	産毛
うぶぎ	産着
うぶ	初
うぶ	産
うばいと	奪い取
うば	乳母
うば	奪
うば	姥
うは	右派
うのみ	鵜呑み
うね	畝
うね	畦
うぬぼれ	自惚れ
うなばら	海原
うなどん	うな丼
うなず	頷
うなじ	項
うなぎ	鰻
うなが	促
うどんこ	饂飩粉
うどんこ	うどん粉
うどん	饂飩
うとん	疎ん
うとまし	疎まし
うどし	卯年
うと	疎
うてん	雨天
うでわ	腕輪
うでまえ	腕前
うでどけい	腕時計
うできき	腕利き
うでぎ	腕木
うで	腕
うつわ	器
うつろ	虚ろ
うつろ	移ろ
うつりぎ	移り気
うつむ	俯
うつぼ	靭
うつびょう	鬱病
うっど	ウッド
うったえ	訴え
うっせき	鬱積
うっせき	うっ積
うつしと	写し取
うつしだ	映し出
うっくつ	鬱屈
うつくし	美し
うづき	卯月
うつ	写
うつ	映
うつ	欝
うつ	移
うちわけ	内訳
うちわ	内輪
うちょうてん	有頂天
うちゅう	宇宙
うちやぶ	打ち破
うちみず	打ち水
うちみ	打ち身
うちまく	内幕
うちぼり	内堀
うちべんけい	内弁慶
うちひし	打ちひし
うちとけ	打ち解け
うちでし	内弟子
うちだ	打ち出
うちすて	打ち捨て
うちこ	打ち込
うちけ	打ち消
うちくだ	打ち砕
うちきん	内金
うちきず	打傷
うちき	内気
うちき	打ち切
うちがわ	内側
うちかけ	打掛け
うちか	打ち勝
うちおと	撃ち落と
うちうち	内々
うちいわい	内祝
うちあわせ	打合せ
うちあわせ	打ち合せ
うちあけばなし	打ち明け話
うちあげ	打ち上げ
うちあけ	打ち明け
うちあ	撃ち合
うち	裡
うち	内
うち	中
うち	家
うたん	右端
うたたね	うたた寝
うたごえ	歌声
うたげ	宴
うたぐりぶか	疑り深
うたぐ	疑
うたがわし	疑わし
うたが	疑
うたい	謡
うた	唱
うた	詩
うた	歌
うた	詠
うた	唄
うそっぱち	嘘っ八
うそく	右側
うぞうむぞう	有象無象
うそ	嘘
うそ	ウソ
うせつ	右折
うせい	迂生
うせ	失せ
うすれ	薄れ
うすら	薄ら
うずもれ	埋もれ
うずめ	埋め
うすめ	薄め
うすまく	薄膜
うずまき	渦巻
うずま	埋ま
うずま	渦巻
うすま	薄ま
うすび	薄日
うすで	薄手
うすちゃ	薄茶
うすじお	薄塩
うすじ	薄地
うすげしょう	薄化粧
うすぐら	薄暗
うずくま	蹲
うすくち	薄口
うすぎり	薄切り
うすぎ	薄着
うすがた	薄型
うすうす	薄々
うすい	雨水
うず	渦
うす	薄
うす	臼
うす	碓
うしろめた	後ろめた
うしろむき	後向き
うしろだて	後ろだて
うしろすがた	後ろ姿
うしろあし	後ろ足
うしろ	後ろ
うじょう	有情
うじむし	蛆虫
うしみつどき	丑三つ刻
うしみつ	丑三つ
うしな	喪
うしな	失
うしどし	丑年
うじがみ	氏神
うしがえる	牛蛙
うしお	潮
うじ	氏
うし	齲歯
うし	牛
うし	丑
うさぎ	菟
うさぎ	兎
うこん	鬱金
うごめ	蠕
うごきだ	動き出
うごか	動か
うご	動
うげん	右舷
うけわたし	受渡し
うけも	受け持
うけみ	受身
うけはらい	受払い
うけにん	請人
うけなが	受け流
うけとり	受取
うけとめ	受け止め
うけと	受け取
うけて	受け手
うけつけ	受付
うけつけ	受け付け
うけつ	受け継
うけたまわ	承
うけしょ	請書
うけざら	受け皿
うけこたえ	受け答え
うけおい	請負
うけお	請け負
うけうり	受け売り
うけいれ	受け入れ
うけい	右傾
うけあ	請け合
うけ	請け
うけ	承け
うけ	受け
うぐいす	鴬
うきよえ	浮世絵
うきぼり	浮き彫り
うきぶくろ	浮袋
うきな	浮名
うきしずみ	浮き沈み
うきくさ	浮草
うき	雨季
うき	雨期
うき	右記
うがん	右岸
うかれ	浮かれ
うかべ	浮かべ
うかつ	迂闊
うかが	伺
うかが	窺
うかい	鵜飼い
うかい	迂回
うか	浮か
うか	受か
うか	羽化
うおうさおう	右往左往
うお	魚
うえん	迂遠
うえは	ウエハ
うえつけ	植え付け
うえじに	餓死
うえした	上下
うえこ	植え込
うえき	植木
うぇい	ウェイ
うえ	植え
うえ	上
うえ	飢え
うーろんちゃ	烏龍茶
ういざん	初産
ういういし	初々し
うい	有為
う	憂
う	浮
う	伐
う	売
う	膿
う	得
う	討
う	打
う	生
う	産
う	撃
う	鵜
いんろう	印籠
いんれき	陰暦
いんりょく	引力
いんりょうすい	飲料水
いんりょう	飲料
いんよう	陰陽
いんよう	飲用
いんよう	引用
いんゆ	隠喩
いんぼう	陰謀
いんび	淫靡
いんばい	淫売
いんねん	因縁
いんとく	隠匿
いんどう	引導
いんとう	淫蕩
いんちょう	院長
いんたい	引退
いんそつ	引率
いんぞく	姻族
いんぜみ	院ゼミ
いんせき	隕石
いんせき	引責
いんせき	姻戚
いんぜい	印税
いんせい	隠棲
いんせい	陰性
いんせい	院生
いんせい	院政
いんすう	因数
いんすう	員数
いんしょく	飲食
いんしょうづけ	印象付け
いんしょうづけ	印象づけ
いんしょう	印象
いんしょう	印章
いんしゅう	因習
いんしゅ	飲酒
いんしつ	陰湿
いんじ	印璽
いんじ	印字
いんし	院試
いんし	因子
いんし	印紙
いんさん	陰惨
いんさつ	印刷
いんこく	印刻
いんごう	因業
いんこう	淫行
いんこう	咽喉
いんけん	陰険
いんぎん	慇懃
いんきん	陰金
いんきょく	陰極
いんきょ	隠居
いんき	陰気
いんかん	印鑑
いんがし	印画紙
いんがい	院外
いんがい	員外
いんが	陰画
いんが	因果
いんか	引火
いんか	印加
いんえい	陰影
いんいおん	陰イオン
いん	韻
いん	陰
いん	飲
いん	因
いん	印
いわはだ	岩肌
いわば	言わば
いわば	岩場
いわば	謂わば
いわし	鰮
いわし	鰯
いわく	曰く
いわかん	違和感
いわかど	岩角
いわお	巌
いわ	磐
いわ	祝
いわ	岩
いろんな	色んな
いろん	異論
いろわけ	色分け
いろめ	色目
いろめ	色め
いろど	彩
いろっぽ	色っぽ
いろづ	色づ
いろずり	色刷
いろこ	色子
いろけ	色気
いろう	遺漏
いろう	慰労
いろいろ	色々
いろいろ	色色
いろあせ	色褪せ
いろあせ	色あせ
いろあい	色合い
いろ	色
いれなお	入れ直
いれぢえ	入れ知恵
いれこ	入れ子
いれこ	入れ込
いれかわ	入れ替わ
いれかえ	入れ替え
いれかえ	入れ換え
いれい	異例
いれい	慰霊
いれ	容れ
いれ	入れ
いるか	海豚
いるい	衣類
いりょく	威力
いりょう	医療
いりょう	衣料
いりゅう	遺留
いりゅう	慰留
いりこ	入り込
いりぐち	入口
いりく	入り組
いりえ	入江
いりえ	入り江
いらだ	苛立
いらか	甍
いらいら	苛々
いらい	依頼
いらい	以来
いよく	意欲
いよう	異様
いよう	威容
いゆう	畏友
いやみったらし	厭味ったらし
いやみ	嫌味
いやみ	厭味
いやま	いや増
いやしめ	卑しめ
いやし	卑し
いやし	賎し
いやけ	嫌気
いやくきん	違約金
いやく	医薬
いやく	違約
いやく	意訳
いやがおうでも	いやが応でも
いやおうなしに	否応なしに
いやおう	否応
いや	癒
いや	嫌
いや	厭
いもん	慰問
いもむし	芋虫
いもの	鋳物
いもうと	妹
いも	芋
いめい	異名
いむ	医務
いみん	移民
いみ	意味
いまわし	忌まわし
いままで	今まで
いまだ	未だ
いましめ	戒め
いましがた	今しがた
いまさら	今更
いまさら	今さら
いまごろ	今ごろ
いまいまし	忌々し
いま	今
いま	居間
いほう	違法
いほう	異邦
いへん	異変
いぶつ	遺物
いぶつ	異物
いふく	衣服
いぶき	息吹
いふう	威風
いふ	畏怖
いひん	遺品
いひょう	意表
いはん	違反
いばら	茨
いばしょ	居場所
いはく	曰く
いはい	違背
いば	威張
いのちづな	命綱
いのちごい	命乞い
いのち	命
いのしし	猪
いのこ	居残
いの	祷
いの	祈
いねむり	居眠り
いねかり	稲刈り
いね	禾
いね	稲
いぬどし	戊年
いぬっころ	犬っころ
いぬころ	犬ころ
いぬき	居抜き
いぬかき	犬かき
いぬい	乾
いぬ	戌
いぬ	射貫
いぬ	犬
いぬ	狗
いにん	委任
いにゅう	移入
いなり	稲荷
いなら	居並
いなびかり	稲光
いなずま	稲妻
いなかっぺ	田舎っぺ
いなか	田舎
いなお	居直
いない	以内
いな	否
いとめ	射止め
いとま	暇
いどばた	井戸端
いとな	営
いとぞこ	糸底
いとしの	愛しの
いどし	亥年
いとし	愛し
いどころ	居所
いとぐち	糸口
いどう	移動
いどう	異同
いどう	異動
いど	挑
いど	井戸
いど	緯度
いと	糸
いと	厭
いと	意図
いでんし	遺伝子
いでん	遺伝
いてん	移転
いてつ	凍てつ
いてき	夷狄
いて	射手
いつわ	偽
いつわ	逸話
いっぽん	一本
いっぽう	一方
いっぽう	一報
いっぽ	一歩
いっぺんとう	一辺倒
いっぺん	一辺
いっぺん	一変
いっぷたさい	一夫多妻
いっぷく	一服
いっぷう	一風
いつぶ	鋳潰
いっぴん	逸品
いっぴつ	一筆
いっぱんてき	一般的
いっぱんか	一般化
いっぱん	一般
いっぱつ	一発
いっぱく	一泊
いっぱい	一杯
いっぱ	一派
いっとき	一時
いっとう	一頭
いっとう	一等
いっと	一途
いってん	一点
いってん	一転
いってい	一定
いって	一手
いつつ	五つ
いっちょうら	一張羅
いっちょういったん	一長一短
いっちょういっせき	一朝一夕
いっちゅうや	一昼夜
いっち	一致
いったん	一端
いったん	一旦
いったん	一たん
いつだつ	逸脱
いったい	一帯
いったい	一体
いっそく	一足
いっそう	一掃
いっそう	一層
いっせん	一線
いっせん	一千
いっせつ	一説
いっせきにちょう	一石二鳥
いっせいに	一斉に
いっせい	一斉
いっせい	一世
いっすい	一睡
いっしんふらん	一心不乱
いっしんに	一心に
いっしんどうたい	一心同体
いっしん	一身
いっしん	一新
いっしん	一心
いっしん	一審
いっしょけんめい	一所懸命
いっしょくた	一緒くた
いっしょくそくはつ	一触即発
いっしょうけんめい	一生懸命
いっしょう	一生
いっしょう	一章
いっしょ	一緒
いっしゅん	一瞬
いっしゅうかん	一週間
いっしゅう	一蹴
いっしゅう	一周
いっしゅ	一首
いっしゅ	一種
いっしつ	一室
いっしつ	一失
いっしき	一式
いっさんかたんそ	一酸化炭素
いっさくねん	一昨年
いっさくじつ	一昨日
いっさいたふ	一妻多夫
いっさいがっさい	一切合財
いつざい	逸材
いっさい	一切
いっこく	一国
いっこく	一刻
いっこう	一行
いっこう	一向
いっけんらくちゃく	一件落着
いっけん	一軒
いっけん	一見
いっけい	一計
いつくし	慈し
いっきょう	一興
いっきょ	一挙
いっきに	一気に
いっきとうせん	一騎当千
いっき	一揆
いっき	一期
いっかん	一貫
いっかん	一環
いっかん	一巻
いっかつ	一括
いっかつ	一喝
いっかせい	一過性
いっかく	一角
いっかい	一回
いっかい	一介
いつか	五日
いつか	5日
いつか	５日
いっか	一家
いっか	一下
いつう	胃痛
いつ	何時
いっ	逸
いちろ	一路
いちれん	一連
いちれい	一例
いちる	一縷
いちりゅう	一流
いちりづか	一里塚
いちりつ	市立
いちりつ	一律
いちり	一理
いちらん	一覧
いちよう	一様
いちょう	銀杏
いちょう	胃腸
いちょ	遺著
いちゅう	意中
いちやく	一躍
いちや	一夜
いちもん	一門
いちもくりょうぜん	一目瞭然
いちもく	一目
いちめん	一面
いちめい	一命
いちまつ	市松
いちまつ	一抹
いちぼう	一望
いちぶん	一文
いちぶぶん	一部分
いちぶ	一部
いちばん	一番
いちはやく	いち早く
いちはや	逸早
いちば	市場
いちねん	一念
いちねん	一年
いちにんまえ	一人前
いちにんしょう	一人称
いちにん	一任
いちどく	一読
いちどき	一時
いちどう	一堂
いちどう	一同
いちど	一度
いちづけ	位置付け
いちづけ	位置づけ
いちだんらく	一段落
いちだん	一段
いちだん	一団
いちたいた	一対多
いちぞん	一存
いちじるし	著し
いちじょ	一助
いちじゅういっさい	一汁一菜
いちじ	一次
いちじ	一時
いちじ	一字
いちじ	一事
いちごん	一言
いちご	苺
いちげん	一言
いちげん	一元
いちげん	一見
いちげき	一撃
いちがん	一眼
いちがん	一丸
いちかごん	一家言
いちがいに	一概に
いちおう	一応
いちえん	一円
いちいん	一因
いちいん	一員
いちいてき	一意的
いちいち	一々
いちい	一意
いち	市
いち	壱
いち	一
いち	位置
いたん	異端
いたれりつくせり	至れり尽くせり
いためつけ	痛めつけ
いため	炒め
いため	痛め
いため	傷め
いたまし	痛まし
いたまえ	板前
いたば	板場
いたで	痛手
いたたまれな	居たたまれな
いたたまらな	居た堪らな
いたたまらな	居たたまらな
いただき	頂
いただ	戴
いたずらに	徒に
いたずら	徒
いたずら	悪戯
いたしかたな	致し方な
いたけだか	居丈高
いたく	委託
いたく	依託
いたいたし	痛々し
いたいじ	異体字
いだい	医大
いだい	偉大
いたい	遺体
いたい	異体
いだ	抱
いた	板
いた	到
いた	悼
いた	痛
いた	致
いた	傷
いた	至
いぞん	異存
いぞん	依存
いそん	依存
いそじ	五十路
いそし	勤し
いぞく	遺族
いそがし	忙し
いそうろう	居候
いぞう	遺贈
いそう	移送
いそう	位相
いそ	急
いそ	磯
いぜんけい	已然形
いぜん	已然
いぜん	依然
いぜん	以前
いせつ	移設
いせつ	異説
いせき	遺跡
いせき	移籍
いせいしゃ	為政者
いせい	異星
いせい	異性
いせい	威勢
いすわ	居座
いずみ	泉
いす	椅子
いしんでんしん	以心伝心
いじん	異人
いじん	偉人
いしん	維新
いしん	威信
いじわる	意地悪
いしょくじゅう	衣食住
いしょく	衣食
いしょく	移植
いしょく	異色
いしょく	委嘱
いじょう	移譲
いじょう	異状
いじょう	異常
いじょう	委譲
いじょう	以上
いしょう	衣装
いしょう	意匠
いしょ	医書
いしょ	遺書
いしゆみ	弩
いしゅつ	移出
いしゅく	萎縮
いじゅう	移住
いしゅう	蝟集
いしゅう	異臭
いしゅ	異種
いしゅ	意趣
いしゃ	医者
いしゃ	慰謝
いじめ	苛め
いしぶみ	碑
いしばし	石橋
いしつ	遺失
いしつ	異質
いしずえ	礎
いしき	意識
いしがき	石垣
いじ	遺児
いじ	維持
いじ	意地
いし	石
いし	医師
いし	遺志
いし	意思
いし	意志
いさん	遺産
いさめ	諌め
いさむ	勇
いさみあし	勇み足
いさみ	勇
いさまし	勇まし
いざな	誘
いさく	遺作
いさぎよ	潔
いざかや	居酒屋
いさかい	諍い
いさか	諍
いさい	異彩
いさい	委細
いさ	勇
いごん	遺言
いこん	遺恨
いこつ	遺骨
いこじ	意固地
いこじ	依怙地
いごこち	居心地
いこく	異国
いこう	移項
いこう	移行
いこう	意向
いこう	以降
いこい	憩い
いこい	憩
いご	囲碁
いご	以後
いげん	威厳
いけん	違憲
いけん	異見
いけん	意見
いけばな	生け花
いけど	生け捕
いげた	井桁
いけがき	生け垣
いけい	畏敬
いけ	池
いけ	生け
いくらか	幾らか
いくら	幾ら
いくぶん	幾分
いくにち	幾日
いくどうおん	異口同音
いくど	幾度
いくつ	幾つ
いくた	幾多
いくせい	育成
いくしゅ	育種
いくじ	育児
いくさ	戦
いくえい	育英
いくえ	幾重
いきわた	行き渡
いきりょう	生霊
いきょく	医局
いきょく	委曲
いきょうと	異教徒
いぎょう	医業
いぎょう	遺業
いぎょう	偉業
いきょう	異郷
いきょう	異境
いきょ	依拠
いきもの	生き物
いきのこ	生き残
いきぬき	息抜き
いきとど	行き届
いきとしいける	生きとし生ける
いきどお	憤
いきづま	息詰ま
いきちが	行き違
いきち	閾値
いきち	生き血
いきすぎ	行き過ぎ
いきさつ	経緯
いきさき	行き先
いきご	意気込
いきぐるし	息苦し
いきぎれ	息切れ
いきき	行き来
いきかえ	生き返
いきがい	生きがい
いきか	閾下
いきおいづ	勢い付
いきおいこ	勢い込
いきおい	勢い
いきうめ	生き埋め
いきいき	生き生き
いぎ	異議
いぎ	異義
いぎ	意義
いき	息
いき	生き
いき	粋
いき	活き
いき	域
いき	遺棄
いき	意気
いがん	胃癌
いがん	依願
いかん	如何
いかん	遺憾
いかん	衣冠
いかん	移管
いかん	尉官
いかり	錨
いかり	碇
いがみあ	いがみ合
いかなる	如何なる
いかどうぶん	以下同文
いがた	鋳型
いかだ	筏
いかすい	胃下垂
いがくぶ	医学部
いがく	医学
いかく	威嚇
いかが	如何
いかいよう	胃潰瘍
いがい	遺骸
いがい	意外
いがい	以外
いか	如何
いか	怒
いか	生か
いか	活か
いか	烏賊
いか	医科
いか	異化
いか	以下
いおり	庵
いおう	硫黄
いえん	胃炎
いえもと	家元
いえで	家出
いえじ	家路
いえがら	家柄
いえ	癒え
いえ	家
いいんかい	委員会
いいん	医院
いいん	委員
いいわた	言い渡
いいわけ	言い訳
いいまわし	言い回し
いいぶん	言い分
いいふら	言い触ら
いいふくめ	言い含め
いいは	言い張
いいのがれ	言い逃れ
いいなずけ	許嫁
いいなお	言い直
いいつけ	言いつけ
いいだしっぺ	言い出しっぺ
いいだくだく	唯々諾々
いいだ	言い出
いいそこな	言い損な
いいすて	言い捨て
いいくるめ	言いくるめ
いいき	言い切
いいかわ	言い交わ
いいかね	言い兼ね
いいかげん	いい加減
いいかえ	言い返
いいかえ	言い替え
いいかえ	言い換え
いいあらわ	言い表
いいあらそ	言い争
いいあ	言い合
いあん	慰安
いあつ	威圧
い	良
い	要
い	入
い	鋳
い	煎
い	射
い	言
い	居
い	忌
い	往
い	云
い	亥
い	井
い	医
い	謂
い	衣
い	胃
い	異
い	意
あんらく	安楽
あんゆ	暗喩
あんやく	暗躍
あんもく	暗黙
あんみん	安眠
あんま	按摩
あんぽ	安保
あんぶん	按分
あんぷ	暗譜
あんぴ	安否
あんばい	塩梅
あんのじょう	案の定
あんに	暗に
あんない	案内
あんど	安堵
あんてな	アンテナ
あんてい	安定
あんちょく	安直
あんちゅうもさく	暗中模索
あんちゅう	暗中
あんち	安置
あんたん	暗澹
あんたい	安泰
あんそく	安息
あんぜん	安全
あんせい	安静
あんず	杏
あんしん	安心
あんしょく	暗色
あんしょう	暗誦
あんしょう	暗証
あんしょう	暗礁
あんしょう	暗唱
あんしょ	暗所
あんしゅつ	案出
あんじゅう	安住
あんしつ	暗室
あんじ	案じ
あんじ	暗示
あんし	暗視
あんざん	暗算
あんさつ	暗殺
あんこく	暗黒
あんこがた	アンコ形
あんごう	暗号
あんこう	鮟鱇
あんこ	アンコ
あんけん	案件
あんきょ	安居
あんき	暗鬼
あんき	暗記
あんかん	安閑
あんがい	案外
あんか	安価
あんうん	暗雲
あんいつ	安逸
あんい	安易
あん	餡
あん	案
あん	按
あわれ	憐れ
あわれ	哀れ
あわゆき	淡雪
あわび	鮑
あわて	慌て
あわだ	泡立
あわせて	併せて
あわせ	併せ
あわせ	合わせ
あわせ	袷
あわさ	合わさ
あわ	泡
あわ	淡
あわ	合わ
あわ	会わ
あわ	粟
あれ	粗れ
あれ	荒れ
あるちゅう	アル中
あるじ	主
あるがまま	有るがまま
あるいは	或は
ある	歩
ある	或
ありゅうさん	亜硫酸
ありゅう	亜流
ありとある	有りとある
ありとあらゆる	有りとあらゆる
ありてい	有り体
ありったけ	有りったけ
ありさま	有り様
ありがね	有り金
ありがとう	有難う
ありがたみ	有難味
ありがたみ	ありがた味
ありがた	有難
ありか	在処
ありあわせ	有り合わせ
あり	有り
あり	蟻
あらわれ	表れ
あらわれ	現われ
あらわれ	現れ
あらわ	露わ
あらわ	表
あらわ	著
あらわ	現
あらりょうじ	荒療治
あらまき	新巻
あらなわ	荒縄
あらなみ	荒波
あらと	荒砥
あらて	新手
あらっぽ	荒っぽ
あらためて	改めて
あらため	改め
あらたま	改ま
あらたか	灼か
あらた	新た
あらそ	争
あらすじ	粗筋
あらしまわ	荒し回
あらし	嵐
あらごなし	荒ごなし
あらけずり	荒削り
あらげ	荒げ
あらくれ	荒くれ
あらぎょう	荒行
あらかた	粗方
あらかじめ	予め
あらが	抗
あらいなが	洗い流
あらいだ	洗い出
あらいそ	荒磯
あらいざらい	洗いざらい
あらいおと	洗い落と
あらあらし	荒々し
あら	粗
あら	洗
あら	荒ら
あら	荒
あゆみよ	歩み寄
あゆ	歩
あゆ	鮎
あゆ	阿諛
あやめ	菖蒲
あやめ	殺め
あやま	謝
あやま	誤
あやま	過
あやぶ	危ぶ
あやつ	操
あやし	妖し
あやし	怪し
あやぎぬ	綺
あやう	危う
あや	文
あや	彪
あや	彩
あや	綾
あや	絢
あめふり	雨降り
あめふり	雨ふり
あめあがり	雨上がり
あめ	雨
あめ	飴
あみめ	網目
あみめ	編目
あみだな	網棚
あみき	編み機
あみかけ	網かけ
あみ	網
あまん	甘ん
あまやか	甘やか
あまもり	雨漏り
あまみず	雨水
あまみ	甘味
あまのじゃく	天邪鬼
あまのじゃく	天の邪鬼
あまど	雨戸
あまでら	尼寺
あまったる	甘ったる
あまだれ	雨だれ
あまた	数多
あまごい	雨乞い
あまぐも	雨雲
あまくち	甘口
あまくだり	天下り
あまから	甘辛
あまがさ	雨傘
あまがさ	雨がさ
あまがさ	雨ガサ
あまがき	甘柿
あまがえる	雨蛙
あまえ	甘え
あまあし	雨足
あま	余
あま	尼
あま	剰
あま	甘
あま	海女
あほうどり	信天翁
あほう	阿呆
あへん	阿片
あふれ	溢れ
あぶらっこ	油っこ
あぶらしょう	脂性
あぶらぎ	脂ぎ
あぶらえ	油絵
あぶら	油
あぶら	脂
あぶみ	鐙
あぶなっかし	危なっかし
あぶな	危な
あぶ	虻
あひる	家鴨
あひる	アヒル
あびせ	浴びせ
あびきょうかん	阿鼻叫喚
あび	浴び
あばれんぼう	暴れん坊
あばれ	暴れ
あばらぼね	肋骨
あばきだ	暴き出
あば	暴
あのよう	あの様
あねったい	亜熱帯
あね	姉
あね	姐
あにき	兄貴
あに	兄
あなど	侮
あなたたち	貴方達
あなたたち	あなた達
あなた	貴方
あなうめ	穴埋め
あな	孔
あな	坑
あな	穴
あともどり	後戻り
あとばらい	後払い
あとつぎ	跡継ぎ
あとぢえ	後知恵
あとち	跡地
あとだし	後出し
あとしまつ	後始末
あとさき	後先
あとがま	後釜
あとかたづけ	後かたづけ
あとがき	後書き
あとおし	後押し
あとあと	後々
あと	蹟
あと	跡
あと	痕
あと	後
あてはめ	当てはめ
あてはま	当てはま
あてな	宛名
あてつけ	当てつけ
あてずっぽう	当てずっぽう
あてじ	当て字
あてじ	宛字
あてじ	宛て字
あてさき	宛先
あて	当て
あて	充て
あて	宛て
あて	宛
あつれき	軋轢
あつりょく	圧力
あつめ	集め
あつめ	厚め
あつま	集ま
あっぱく	圧迫
あっとう	圧倒
あつで	厚手
あっせん	斡旋
あっせい	圧制
あっしょう	圧勝
あっしゅく	圧縮
あつじ	厚地
あっし	圧死
あっさつ	圧殺
あっさく	圧搾
あつさ	暑さ
あっこう	悪口
あっけな	呆気な
あつげしょう	厚化粧
あっけ	呆気
あつくるし	暑苦し
あつぎ	厚着
あつかん	熱燗
あっかん	圧巻
あっかん	悪漢
あつがみ	厚紙
あつかまし	厚かまし
あつかいだか	扱い高
あつか	扱
あっか	悪化
あつえん	圧延
あつ	熱
あつ	篤
あつ	暑
あつ	厚
あっ	圧
あたりまえ	当り前
あたりまえ	当たり前
あたりまえ	当たりまえ
あたり	辺り
あたらし	新し
あたまごなし	頭ごなし
あたまきん	頭金
あたまかず	頭数
あたまうち	頭打ち
あたま	頭
あだばな	徒花
あたため	暖め
あたため	温め
あたたま	暖ま
あたたま	温ま
あたたか	暖か
あたたか	温か
あたえ	与え
あたい	値
あたい	価
あだ	徒
あだ	仇
あた	当た
あた	当
あそびまわ	遊び回
あそびごころ	遊び心
あそ	遊
あぜんと	唖然と
あぜくら	校倉
あせかき	汗かき
あぜ	畔
あぜ	畦
あせ	褪せ
あせ	焦
あせ	汗
あずま	東
あずさ	梓
あずけいれ	預け入れ
あずけ	預け
あずき	小豆
あずか	預か
あずか	預
あずか	与
あす	明日
あじわ	味わ
あしゅ	亜種
あしもと	足元
あじみ	味見
あしび	馬酔木
あしなみ	足並み
あしどり	足取り
あじつけ	味付け
あした	明日
あしずり	足摺
あししげく	足繁く
あじさい	紫陽花
あしこし	足腰
あじけな	味気な
あしくび	足首
あしきしゅうきゅう	ア式蹴球
あしがる	足軽
あしがため	足固め
あしかけ	足掛け
あしがかり	足掛り
あしがかり	足掛かり
あしおと	足音
あしあと	足跡
あじ	鰺
あじ	味
あじ	鯵
あし	足
あし	脚
あし	芦
あし	葦
あし	悪し
あさり	鯏
あざらし	海豹
あさゆう	朝夕
あさやけ	朝焼け
あざやか	鮮やか
あさめし	朝飯
あざむ	欺
あさまし	浅まし
あさひ	朝日
あさひ	旭
あさばん	朝晩
あざな	糾
あさっぱら	朝っぱら
あさって	明後日
あさぢえ	浅知恵
あさせ	浅瀬
あざけ	嘲
あさげ	朝餉
あさぐろ	浅黒
あさく	浅く
あさがた	朝方
あさいち	朝市
あざ	字
あさ	麻
あさ	朝
あさ	浅
あさ	漁
あこがれ	憧れ
あご	顎
あけわた	明け渡
あけぼの	曙
あけはな	開け放
あげつら	論
あけっぴろげ	開けっ広げ
あげぞこ	上げ底
あげしお	上潮
あげく	挙げ句
あけがた	明け方
あげあし	揚足
あげあし	揚げ足
あげあし	上足
あげあし	上げ足
あげあし	挙足
あげあし	挙げ足
あげ	揚げ
あげ	上げ
あげ	挙げ
あけ	明け
あけ	朱
あけ	空け
あけ	開け
あくりょく	握力
あくりょう	悪霊
あくよう	悪用
あくゆう	悪友
あくやく	悪役
あくめい	悪名
あくむ	悪夢
あくみょう	悪名
あくま	悪魔
あくへき	悪癖
あくへい	悪弊
あくびょうどう	悪平等
あくびょう	悪病
あくば	悪罵
あくにん	悪人
あくとく	悪徳
あくだま	悪玉
あくたい	悪態
あくた	芥
あくせん	悪銭
あくせん	悪戦
あくせい	悪性
あくしゅみ	悪趣味
あくしゅう	悪臭
あくしゅ	握手
あくしゅ	悪手
あくしつ	悪質
あくしつ	悪疾
あくじき	悪食
あくじ	悪事
あくえき	悪疫
あくい	悪意
あぐ	倦
あく	悪
あきれすけん	アキレス腱
あきれ	呆れ
あきらめ	諦め
あきらか	明らか
あきや	空き家
あきばれ	秋晴れ
あきない	商い
あきな	商
あきち	空き地
あきす	空巣
あきさめ	秋雨
あき	飽き
あき	秋
あき	厭き
あかんぼう	赤ん坊
あかるみ	明るみ
あかる	明る
あかり	明り
あかり	明かり
あかり	灯
あからがお	赤ら顔
あから	赤ら
あかまる	赤丸
あかまつ	赤松
あかぼう	赤帽
あかね	茜
あかぬけ	垢抜け
あかっぱじ	赤っ恥
あかつち	赤土
あかつき	暁
あかちん	赤チン
あかせん	赤線
あかしお	赤潮
あかじ	赤字
あかし	灯
あかし	証
あかご	赤子
あかげら	赤啄木鳥
あかげ	赤毛
あかがい	赤貝
あかおに	赤鬼
あが	揚が
あが	騰が
あが	足掻
あが	上が
あが	挙が
あか	明か
あか	飽か
あか	赤
あか	垢
あおやぎ	青柳
あおもの	青物
あおむし	青虫
あおば	青葉
あおた	青田
あおぞら	青空
あおじろ	青白
あおざめ	青ざめ
あおがえる	青蛙
あおおに	青鬼
あおい	葵
あおあお	青々
あお	碧
あお	蒼
あお	煽
あお	扇
あお	青
あお	仰
あえん	亜鉛
あえな	敢な
あえて	敢えて
あえ	喘
あえ	和え
あうん	阿吽
あいろ	隘路
あいらし	愛らし
あいらく	哀楽
あいよう	愛用
あいまい	曖昧
あいま	合間
あいべつ	哀別
あいぶ	愛撫
あいびき	逢引
あいにく	生憎
あいどく	愛読
あいとう	哀悼
あいてさき	相手先
あいて	相手
あいつう	相通
あいつ	相次
あいつ	相継
あいちょう	愛鳥
あいちゃく	愛着
あいだがら	間柄
あいたい	相対
あいだ	間
あいぞう	愛憎
あいそ	愛想
あいせつ	哀切
あいせき	哀惜
あいず	合図
あいす	アイス
あいじん	愛人
あいじょう	愛情
あいしょう	相性
あいしょう	愛誦
あいしょう	愛称
あいしょう	愛唱
あいしゅう	哀愁
あいじ	愛児
あいさつ	挨拶
あいさい	愛妻
あいことな	相異な
あいこく	愛国
あいこう	愛好
あいご	愛護
あいこ	愛顧
あいけん	愛犬
あいくち	匕首
あいきょう	愛嬌
あいきょう	愛敬
あいがん	愛玩
あいがん	哀願
あいかん	哀歓
あいかわらず	相変わらず
あいかた	相方
あいかぎ	合鍵
あいか	哀歌
あいおい	相生
あいいれな	相容れな
あい	藍
あい	愛
ああ	嗚呼
あ	有
あ	明
あ	飽
あ	編
あ	遭
あ	在
あ	合
あ	空
あ	開
あ	会
あ	逢
